year2,state,firms,estabs,emp,denom,estabs_entry,estabs_entry_rate,estabs_exit,estabs_exit_rate,job_creation,job_creation_births,job_creation_continuers,job_creation_rate_births,job_creation_rate,job_destruction,job_destruction_deaths,job_destruction_continuers,job_destruction_rate_deaths,job_destruction_rate,net_job_creation,net_job_creation_rate,reallocation_rate,d_flag,firmdeath_firms,firmdeath_estabs,firmdeath_emp
1977,01,52371,62852,957297,933909,10634,17.2,8057,13.1,191522,89869,101653,9.6,20.5,144746,58891,85855,6.3,15.5,46776,5,31,0,5623,5641,36602
1977,02,6480,7725,107164,108134,2028,27,1564,20.8,37545,19259,18286,17.8,34.7,39485,13504,25981,12.5,36.5,-1940,-1.8,69.4,0,1035,1039,6757
1977,04,36477,44113,604551,589552,9379,22,6230,14.6,147426,70645,76781,12,25,117429,45366,72063,7.7,19.9,29997,5.1,39.8,0,4332,4357,29116
1977,05,35499,40702,551110,529709,7291,18.3,5455,13.7,119728,44527,75201,8.4,22.6,76925,32531,44394,6.1,14.5,42803,8.1,29,0,3970,3994,19678
1977,06,362887,438766,6813306,6484959,88187,20.7,60589,14.2,1739378,779164,960214,12,26.8,1082685,488562,594123,7.5,16.7,656693,10.1,33.4,0,39693,39932,276475
1977,08,51642,60187,814142,786550,12874,22.2,8248,14.2,198243,93270,104973,11.9,25.2,143058,62313,80745,7.9,18.2,55185,7,36.4,0,5673,5694,37131
1977,09,53879,61410,1103810,1059999,9153,15.2,6634,11,214850,69857,144993,6.6,20.3,127228,47273,79955,4.5,12,87622,8.3,24,0,4248,4263,24208
1977,10,9919,11465,223135,220859,1954,17.6,1250,11.2,34817,14260,20557,6.5,15.8,30264,9058,21206,4.1,13.7,4553,2.1,27.4,0,807,810,5417
1977,11,13027,15041,296878,296031,2262,15.2,1855,12.5,59424,27830,31594,9.4,20.1,57729,20610,37119,7,19.5,1695,0.6,39,0,1131,1135,9899
1977,12,151970,182091,2418901,2316656,36816,20.7,27045,15.2,622874,319998,302876,13.8,26.9,418383,191982,226401,8.3,18.1,204491,8.8,36.2,0,19132,19236,120706
1977,13,78451,95914,1492881,1452463,17573,18.7,13166,14,319926,146754,173172,10.1,22,239090,97339,141751,6.7,16.5,80836,5.5,33,0,8877,8911,56643
1977,15,14785,17914,261107,253382,3306,19,2150,12.4,55585,27592,27993,10.9,21.9,40134,19811,20323,7.8,15.8,15451,6.1,31.6,0,1422,1438,10556
1977,16,16105,18790,259122,231419,3729,20.5,2500,13.7,92116,24359,67757,10.5,39.8,36709,15378,21331,6.6,15.9,55407,23.9,31.8,0,1738,1749,9788
1977,17,175560,204938,3919126,3811704,30780,15.2,25527,12.6,745823,293000,452823,7.7,19.6,530978,202049,328929,5.3,13.9,214845,5.7,27.8,0,16751,16871,107141
1977,18,79024,95182,1708501,1669441,14426,15.4,11454,12.2,298827,122035,176792,7.3,17.9,220707,81202,139505,4.9,13.2,78120,4.7,26.4,0,7438,7499,50182
1977,19,54755,64042,837737,809119,10154,16.1,7961,12.6,169112,68130,100982,8.4,20.9,111876,50775,61101,6.3,13.8,57236,7.1,27.6,0,5274,5295,31820
1977,20,44466,51782,683842,655567,8534,16.7,6944,13.6,159934,86853,73081,13.2,24.4,103384,44771,58613,6.8,15.8,56550,8.6,31.6,0,4706,4729,26825
1977,21,50186,58576,916744,885353,9711,16.8,7697,13.3,193491,73635,119856,8.3,21.9,130708,52001,78707,5.9,14.8,62783,7.1,29.6,0,5214,5226,31052
1977,22,58952,70029,1022023,992319,11802,17.3,8216,12,223320,96403,126917,9.7,22.5,163911,61750,102161,6.2,16.5,59409,6,33,0,5819,5852,37703
1977,23,18929,21673,292547,283875,3441,16.2,2749,12.9,59880,27020,32860,9.5,21.1,42535,16956,25579,6,15,17345,6.1,30,0,1756,1762,9457
1977,24,57557,68669,1126419,1112672,11007,16.4,8105,12,222740,87380,135360,7.9,20,195246,65776,129470,5.9,17.5,27494,2.5,35,0,5202,5223,33840
1977,25,93706,108715,1950437,1881581,14690,13.7,12039,11.2,389454,156633,232821,8.3,20.7,251741,104349,147392,5.5,13.4,137713,7.3,26.8,0,7820,7849,55353
1977,26,122826,147031,2718210,2620761,23171,16,18173,12.6,532694,198770,333924,7.6,20.3,337796,129324,208472,4.9,12.9,194898,7.4,25.8,0,11444,11516,71034
1977,27,65489,76960,1282711,1230894,12235,16.2,8977,11.9,282379,108577,173802,8.8,22.9,178745,73208,105537,5.9,14.5,103634,8.4,29,0,5779,5833,43594
1977,28,34771,40703,580973,560084,6881,17.2,5252,13.1,122810,48125,74685,8.6,21.9,81031,34706,46325,6.2,14.5,41779,7.4,29,0,3728,3754,22449
1977,29,79865,94772,1509107,1469236,15093,16.1,12456,13.3,296851,113532,183319,7.7,20.2,217108,89617,127491,6.1,14.8,79743,5.4,29.6,0,8281,8321,47534
1977,30,16633,18922,190971,178501,3670,20,2397,13.1,53808,23009,30799,12.9,30.1,28867,13323,15544,7.5,16.2,24941,13.9,32.4,0,1670,1675,9899
1977,31,31391,36091,473469,451602,5742,16.2,4374,12.3,116039,38510,77529,8.5,25.7,72305,29267,43038,6.5,16,43734,9.7,32,0,2971,2982,19346
1977,32,12872,14682,235292,224173,3258,23.1,2044,14.5,57171,24771,32400,11,25.5,34933,15357,19576,6.9,15.6,22238,9.9,31.2,0,1465,1469,9485
1977,33,16553,18449,262122,253772,3204,17.9,2063,11.5,51197,20146,31051,7.9,20.2,34497,14599,19898,5.8,13.6,16700,6.6,27.2,0,1400,1407,8623
1977,34,124638,141637,2299737,2258998,20677,14.8,17341,12.4,428101,178309,249792,7.9,19,346624,131558,215066,5.8,15.3,81477,3.7,30.6,0,11014,11057,63980
1977,35,20904,24176,274218,266415,4889,20.8,3459,14.7,67103,33274,33829,12.5,25.2,51497,22137,29360,8.3,19.3,15606,5.9,38.6,0,2421,2429,13603
1977,36,312227,353279,5536480,5434966,48067,13.7,44902,12.8,1044640,402075,642565,7.4,19.2,841611,323854,517757,6,15.5,203029,3.7,31,0,31294,31402,181801
1977,37,84511,102521,1750994,1719698,16734,16.7,12387,12.3,306589,132489,174100,7.7,17.8,243998,88097,155901,5.1,14.2,62591,3.6,28.4,0,8384,8412,51648
1977,38,13177,14917,149212,146646,2435,16.6,1871,12.8,29553,14237,15316,9.7,20.2,24420,10832,13588,7.4,16.7,5133,3.5,33.4,0,1170,1175,7566
1977,39,152029,189077,3541886,3436627,27571,14.8,21859,11.7,662140,255150,406990,7.4,19.3,451622,171098,280524,5,13.1,210518,6.2,26.2,0,13726,13812,90134
1977,40,50336,58471,746499,721654,10526,18.4,7817,13.7,165023,78333,86690,10.9,22.9,115332,50346,64986,7,16,49691,6.9,32,0,5626,5652,32495
1977,41,46565,54000,695771,672087,10970,20.9,7492,14.3,155633,71803,83830,10.7,23.2,108265,50465,57800,7.5,16.1,47368,7.1,32.2,0,4972,4997,30325
1977,42,174493,208707,3850306,3747564,28483,13.8,22690,11,710065,274187,435878,7.3,18.9,504582,183802,320780,4.9,13.5,205483,5.4,27,0,14433,14526,94367
1977,44,17573,19459,358031,324421,2770,14.4,2227,11.6,106314,18286,88028,5.6,32.8,39094,14848,24246,4.6,12.1,67220,20.7,24.2,0,1452,1462,7106
1977,45,42348,50173,839446,827937,8438,17.2,6094,12.4,136945,59698,77247,7.2,16.5,113927,41938,71989,5.1,13.8,23018,2.7,27.6,0,4204,4229,23887
1977,46,13882,15605,195310,171956,2501,16.2,2013,13.1,71785,25862,45923,15,41.7,25076,10499,14577,6.1,14.6,46709,27.1,29.2,0,1255,1255,6637
1977,47,65615,78338,1313122,1273560,13760,17.9,10117,13.2,267610,121560,146050,9.5,21,188486,74336,114150,5.8,14.8,79124,6.2,29.6,0,6941,6971,44016
1977,48,214505,263754,3989853,3845503,49803,19.4,34101,13.3,940603,434064,506539,11.3,24.5,651904,264045,387859,6.9,17,288699,7.5,34,0,23575,23750,157804
1977,49,21269,24554,356335,339655,5073,21.4,3305,14,92694,38733,53961,11.4,27.3,59333,26057,33276,7.7,17.5,33361,9.8,35,0,2147,2167,15813
1977,50,10485,11609,145067,139006,1914,16.9,1347,11.9,31309,13726,17583,9.9,22.5,19186,8799,10387,6.3,13.8,12123,8.7,27.6,0,909,912,4669
1977,51,72552,88154,1391486,1360683,14413,16.7,10720,12.4,282893,127378,155515,9.4,20.8,221288,79434,141854,5.8,16.3,61605,4.5,32.6,0,6985,7027,42951
1977,53,66226,77856,1027796,982351,15570,20.7,10117,13.4,242712,112311,130401,11.4,24.7,151821,65408,86413,6.7,15.5,90891,9.2,31,0,6565,6595,39509
1977,54,26551,30888,471881,459237,4779,15.7,3800,12.5,98590,41437,57153,9,21.5,73301,31646,41655,6.9,16,25289,5.5,32,0,2463,2478,13568
1977,55,75854,87660,1435284,1401243,13131,15.3,9807,11.4,238748,96695,142053,6.9,17,170665,69944,100721,5,12.2,68083,4.8,24.4,0,6219,6269,38462
1977,56,9659,10761,109297,102991,2260,21.9,1373,13.3,31498,15382,16116,14.9,30.6,18886,8866,10020,8.6,18.3,12612,12.3,36.6,0,926,928,6309
1978,01,54168,65096,1032199,994708,10260,16,8002,12.5,213066,72111,140955,7.2,21.4,138084,55224,82860,5.6,13.9,74982,7.5,27.8,0,5667,5688,30942
1978,02,6761,8010,110205,108602,1799,22.9,1484,18.9,36004,13069,22935,12,33.2,32797,15082,17715,13.9,30.2,3207,3,60.4,0,837,842,6987
1978,04,35147,43021,658047,630226,7743,17.8,8348,19.2,163005,60241,102764,9.6,25.9,107364,56864,50500,9,17,55641,8.9,34,0,4885,4931,28307
1978,05,33699,38928,563697,556487,5932,14.9,7208,18.1,107630,36140,71490,6.5,19.3,93210,47659,45551,8.6,16.7,14420,2.6,33.4,0,4419,4434,21675
1978,06,375003,452620,7242053,7022464,81007,18.2,66905,15,1681977,596335,1085642,8.5,24,1242798,528511,714287,7.5,17.7,439179,6.3,35.4,0,41450,41725,247948
1978,08,50226,59213,877002,843859,10793,18.1,11113,18.6,213074,73365,139709,8.7,25.2,146788,74935,71853,8.9,17.4,66286,7.8,34.8,0,6706,6740,38425
1978,09,55495,63208,1139761,1121703,8081,13,6271,10.1,192891,52710,140181,4.7,17.2,156775,63706,93069,5.7,14,36116,3.2,28,0,4291,4308,32288
1978,10,9701,11289,222953,223021,1455,12.8,1633,14.4,58970,9385,49585,4.2,26.4,59105,40838,18267,18.3,26.5,-135,-0.1,52.8,0,1231,1232,34224
1978,11,13227,15244,317327,307089,1950,12.9,1755,11.6,62539,16796,45743,5.5,20.4,42062,16725,25337,5.4,13.7,20477,6.7,27.4,0,1122,1138,8149
1978,12,159721,190761,2564420,2491389,35042,18.8,26327,14.1,620310,241170,379140,9.7,24.9,474247,190812,283435,7.7,19,146063,5.9,38,0,18883,18967,110612
1978,13,81041,98922,1615900,1554502,15577,16,12529,12.9,340752,116387,224365,7.5,21.9,217957,93045,124912,6,14,122795,7.9,28,0,8709,8746,52218
1978,15,15388,18557,275407,268253,2833,15.5,2190,12,56182,21978,34204,8.2,20.9,41873,20138,21735,7.5,15.6,14309,5.3,31.2,0,1405,1419,7582
1978,16,15632,18330,229891,243944,3062,16.5,3288,17.7,55173,21739,33434,8.9,22.6,83278,20769,62509,8.5,34.1,-28105,-11.5,45.2,0,1912,1921,9996
1978,17,178543,208502,4077209,3997676,27486,13.3,23997,11.6,711840,219052,492788,5.5,17.8,552773,201422,351351,5,13.8,159067,4,27.6,0,16387,16528,98513
1978,18,81021,97478,1829792,1768937,13090,13.6,10729,11.1,328339,90438,237901,5.1,18.6,206628,77489,129139,4.4,11.7,121711,6.9,23.4,0,7320,7361,40910
1978,19,56025,65568,876252,856849,8988,13.9,7426,11.5,158952,54955,103997,6.4,18.6,120145,41676,78469,4.9,14,38807,4.6,28,0,5339,5364,25468
1978,20,45724,53325,701191,691984,7850,14.9,6264,11.9,140147,51261,88886,7.4,20.3,121732,41566,80166,6,17.6,18415,2.7,35.2,0,4417,4430,23865
1978,21,51398,60188,956505,936461,9082,15.3,7408,12.5,183834,60162,123672,6.4,19.6,143745,60125,83620,6.4,15.3,40089,4.3,30.6,0,5233,5245,25056
1978,22,56705,68048,1108497,1062924,9461,13.7,10691,15.5,253610,74763,178847,7,23.9,162463,73187,89276,6.9,15.3,91147,8.6,30.6,0,6345,6371,36249
1978,23,19655,22500,309285,297080,3418,15.5,2533,11.5,62105,19027,43078,6.4,20.9,37694,14471,23223,4.9,12.7,24411,8.2,25.4,0,1807,1812,8329
1978,24,59019,70407,1175008,1150318,9599,13.8,7874,11.3,221323,69148,152175,6,19.2,171943,62982,108961,5.5,14.9,49380,4.3,29.8,0,5222,5244,29272
1978,25,95418,110492,2095657,2022855,13209,12.1,11451,10.4,398582,114895,283687,5.7,19.7,252978,110877,142101,5.5,12.5,145604,7.2,25,0,7618,7672,48507
1978,26,125933,150639,2886547,2793463,21107,14.2,17433,11.7,519810,166774,353036,6,18.6,333643,138606,195037,5,11.9,186167,6.7,23.8,0,11581,11637,69164
1978,27,67767,79558,1372682,1327630,11114,14.2,8496,10.9,285420,83671,201749,6.3,21.5,195315,67708,127607,5.1,14.7,90105,6.8,29.4,0,5870,5900,34237
1978,28,35073,41205,607804,594424,6185,15.1,5694,13.9,120034,42856,77178,7.2,20.2,93274,33980,59294,5.7,15.7,26760,4.5,31.4,0,3800,3811,17983
1978,29,81346,96711,1592801,1550852,14054,14.7,12019,12.6,310199,99056,211143,6.4,20,226300,93361,132939,6,14.6,83899,5.4,29.2,0,8268,8297,40896
1978,30,15956,18322,196839,193375,2890,15.5,3267,17.5,46716,16139,30577,8.3,24.2,39788,19624,20164,10.1,20.6,6928,3.6,41.2,0,1916,1920,9760
1978,31,32033,36894,481365,477295,5004,13.7,4157,11.4,98350,30239,68111,6.3,20.6,90209,33233,56976,7,18.9,8141,1.7,37.8,0,2951,2975,15148
1978,32,12572,14468,268367,251213,2841,19.5,2875,19.7,72802,25063,47739,10,29,38493,23286,15207,9.3,15.3,34309,13.7,30.6,0,1633,1637,11388
1978,33,17428,19426,295324,278607,3132,16.5,2141,11.3,65438,25241,40197,9.1,23.5,32004,13161,18843,4.7,11.5,33434,12,23,0,1528,1534,7214
1978,34,127081,144463,2401481,2348078,19059,13.3,16284,11.4,445123,137481,307642,5.9,19,338317,139931,198386,6,14.4,106806,4.6,28.8,0,10775,10816,58403
1978,35,19821,23243,293460,282983,3820,16.1,4419,18.6,73568,25533,48035,9,26,52614,29780,22834,10.5,18.6,20954,7.4,37.2,0,2715,2719,17516
1978,36,313062,353760,5767494,5662022,43751,12.4,43379,12.3,1102841,315152,787689,5.6,19.5,891896,353722,538174,6.2,15.8,210945,3.7,31.6,0,30832,30932,172072
1978,37,87640,106079,1854259,1799943,15728,15.1,12132,11.6,325298,108021,217277,6,18.1,216667,91530,125137,5.1,12,108631,6.1,24,0,8526,8562,43857
1978,38,13603,15383,163000,156069,2203,14.5,1709,11.3,33364,11304,22060,7.2,21.4,19501,8124,11377,5.2,12.5,13863,8.9,25,0,1189,1193,5327
1978,39,154897,192855,3668154,3603082,24430,12.8,20672,10.8,615564,178168,437396,4.9,17.1,485421,163584,321837,4.5,13.5,130143,3.6,27,0,13610,13667,71255
1978,40,47600,55988,775446,759417,8755,15.3,10543,18.4,163120,59579,103541,7.8,21.5,131061,71350,59711,9.4,17.3,32059,4.2,34.6,0,6344,6360,36622
1978,41,49114,56878,799944,747631,10748,19.4,7828,14.1,205497,69772,135725,9.3,27.5,100870,52049,48821,7,13.5,104627,14,27,0,5283,5301,27853
1978,42,176944,211614,3918918,3879649,25306,12,22355,10.6,694443,198829,495614,5.1,17.9,615904,235586,380318,6.1,15.9,78539,2,31.8,0,14774,14859,119050
1978,44,17892,19843,333586,345722,2499,12.7,2088,10.6,67642,20710,46932,6,19.6,91914,18484,73430,5.3,26.6,-24272,-7,39.2,0,1438,1440,7988
1978,45,43868,52112,913419,875944,8030,15.7,6095,11.9,172974,64901,108073,7.4,19.7,98024,39626,58398,4.5,11.2,74950,8.5,22.4,0,4392,4403,18593
1978,46,14365,16130,171051,182954,2415,15.2,1864,11.7,37322,12789,24533,7,20.4,61127,9076,52051,5,33.4,-23805,-13,40.8,0,1305,1306,5665
1978,47,67459,80407,1386606,1350566,12067,15.2,9967,12.6,271544,87492,184052,6.5,20.1,199464,78670,120794,5.8,14.8,72080,5.3,29.6,0,6950,6972,38450
1978,48,204020,254416,4209702,4089419,40567,15.7,46430,17.9,957194,326654,630540,8,23.4,716628,357495,359133,8.7,17.5,240566,5.9,35,0,26558,26702,174431
1978,49,20623,24015,376561,365349,4125,17,4355,17.9,85458,31944,53514,8.7,23.4,63033,31018,32015,8.5,17.3,22425,6.1,34.6,0,2401,2410,14870
1978,50,11078,12226,157550,151138,1913,16.1,1288,10.8,35925,13881,22044,9.2,23.8,23100,12244,10856,8.1,15.3,12825,8.5,30.6,0,961,968,4973
1978,51,75541,91681,1476758,1433692,13626,15.2,10060,11.2,285933,93808,192125,6.5,19.9,199800,82262,117538,5.7,13.9,86133,6,27.8,0,6880,6907,42339
1978,53,69558,81677,1199385,1113157,15023,18.8,11137,14,329364,104323,225041,9.4,29.6,156907,73594,83313,6.6,14.1,172457,15.5,28.2,0,7033,7057,40738
1978,54,26917,31297,453398,462161,4177,13.4,3756,12.1,72588,23609,48979,5.1,15.7,90115,24020,66095,5.2,19.5,-17527,-3.8,31.4,0,2478,2484,11280
1978,55,78852,91036,1545553,1489387,12536,14,9124,10.2,271164,83921,187243,5.6,18.2,158834,67604,91230,4.5,10.7,112330,7.5,21.4,0,6361,6389,34761
1978,56,9470,10634,124356,116514,1984,18.5,1971,18.4,37200,13906,23294,11.9,31.9,21516,12265,9251,10.5,18.5,15684,13.4,37,0,1178,1180,6059
1979,01,54730,65955,1083112,1055982,9436,14.4,8106,12.4,219356,75192,144164,7.1,20.8,165095,64732,100363,6.1,15.6,54261,5.2,31.2,0,5899,5914,35731
1979,02,7058,8298,107880,108822,1804,22.1,1400,17.2,28914,11685,17229,10.7,26.6,30798,12091,18707,11.1,28.3,-1884,-1.7,53.2,0,904,907,5560
1979,04,40325,48734,768197,714182,9229,20.1,3881,8.5,201778,75771,126007,10.6,28.3,93748,31143,62605,4.4,13.1,108030,15.2,26.2,0,118,132,1452
1979,05,36633,41977,602544,583549,6430,15.9,3658,9,113655,43304,70351,7.4,19.5,75665,22603,53062,3.9,13,37990,6.5,26,0,66,73,2171
1979,06,397902,478672,7908786,7568239,89981,19.3,60626,13,1856481,720477,1136004,9.5,24.5,1175386,475544,699842,6.3,15.5,681095,9,31,0,41901,42089,257452
1979,08,56438,65644,985855,932493,12087,19.4,6051,9.7,234838,89746,145092,9.6,25.2,128113,47808,80305,5.1,13.7,106725,11.5,27.4,0,106,123,3424
1979,09,56971,64839,1210157,1174374,7968,12.4,6031,9.4,199513,62534,136979,5.3,17,127947,45613,82334,3.9,10.9,71566,6.1,21.8,0,4160,4167,21983
1979,10,9922,11562,204267,213347,1545,13.5,1203,10.5,31330,11430,19900,5.4,14.7,49489,8172,41317,3.8,23.2,-18159,-8.5,29.4,0,809,820,3978
1979,11,13368,15419,343909,330425,1872,12.2,1607,10.5,64478,14835,49643,4.5,19.5,37510,15052,22458,4.6,11.4,26968,8.1,22.8,0,1053,1054,6545
1979,12,167423,200091,2784206,2671506,35973,18.4,25357,13,657822,265284,392538,9.9,24.6,432422,182847,249575,6.8,16.2,225400,8.4,32.4,0,18717,18822,114510
1979,13,82563,101415,1697217,1656238,15322,15.3,12250,12.2,327931,125154,202777,7.6,19.8,245973,89695,156278,5.4,14.9,81958,4.9,29.8,0,8777,8797,46769
1979,15,16172,19545,299553,287811,3148,16.5,2052,10.8,64197,24331,39866,8.5,22.3,40713,15616,25097,5.4,14.1,23484,8.2,28.2,0,1398,1407,8575
1979,16,17198,20007,272999,252502,3259,17,1729,9,78745,48351,30394,19.1,31.2,37751,11796,25955,4.7,15,40994,16.2,30,0,33,34,369
1979,17,179478,210329,4256138,4163606,26460,12.6,23364,11.2,750179,235057,515122,5.6,18,565116,212717,352399,5.1,13.6,185063,4.4,27.2,0,16189,16242,99206
1979,18,81904,98946,1890281,1858703,12611,12.8,10611,10.8,306681,94981,211700,5.1,16.5,243526,79536,163990,4.3,13.1,63155,3.4,26.2,0,7566,7599,41438
1979,19,55826,65548,917685,896269,7941,12.1,7600,11.6,158850,52737,106113,5.9,17.7,116018,45603,70415,5.1,12.9,42832,4.8,25.8,0,5485,5546,26839
1979,20,46263,54040,745833,722802,7218,13.4,6219,11.6,145169,46496,98673,6.4,20.1,99106,39881,59225,5.5,13.7,46063,6.4,27.4,0,4448,4460,22021
1979,21,52229,61390,1010773,982930,8596,14.1,7006,11.5,196254,67028,129226,6.8,20,140567,51855,88712,5.3,14.3,55687,5.7,28.6,0,5151,5164,29037
1979,22,62363,74231,1215874,1165412,11200,15.7,5514,7.8,260822,89541,171281,7.7,22.4,159897,50712,109185,4.4,13.7,100925,8.7,27.4,0,57,76,1700
1979,23,19874,22803,316863,312846,3054,13.5,2590,11.4,53585,19386,34199,6.2,17.1,45551,15106,30445,4.8,14.6,8034,2.5,29.2,0,1844,1850,8580
1979,24,60029,71902,1229340,1201420,9756,13.7,7883,11.1,222563,73270,149293,6.1,18.5,166723,65363,101360,5.4,13.9,55840,4.6,27.8,0,5445,5480,29949
1979,25,96906,112318,2204948,2149249,13252,11.9,10914,9.8,386812,115994,270818,5.4,18,275415,88442,186973,4.1,12.8,111397,5.2,25.6,0,7506,7533,45723
1979,26,127979,153321,3063642,2985065,20204,13.3,16678,11,509811,160823,348988,5.4,17.1,352657,126469,226188,4.2,11.8,157154,5.3,23.6,0,11511,11570,69149
1979,27,69373,81497,1472406,1422387,10829,13.4,8499,10.6,283967,92124,191843,6.5,20,183931,66064,117867,4.6,12.9,100036,7.1,25.8,0,5920,5940,33403
1979,28,36186,42542,646372,626893,6614,15.8,4992,11.9,130446,45033,85413,7.2,20.8,91487,34492,56995,5.5,14.6,38959,6.2,29.2,0,3734,3745,19545
1979,29,82490,98170,1682200,1635903,13335,13.7,11340,11.6,306031,94849,211182,5.8,18.7,213436,81578,131858,5,13,92595,5.7,26,0,7979,8040,43086
1979,30,17673,20098,228065,212784,3324,17.3,1689,8.8,58211,19182,39029,9,27.4,27649,8756,18893,4.1,13,30562,14.4,26,0,20,20,221
1979,31,32331,37234,501202,490865,4608,12.4,4047,10.9,92976,28082,64894,5.7,18.9,72302,22789,49513,4.6,14.7,20674,4.2,29.4,0,2796,2802,12552
1979,32,14667,16788,321763,295553,3551,22.7,1366,8.7,90202,37943,52259,12.8,30.5,37782,13059,24723,4.4,12.8,52420,17.7,25.6,0,90,91,842
1979,33,17921,20047,320500,307687,2936,14.9,2196,11.1,63455,19477,43978,6.3,20.6,37828,14011,23817,4.6,12.3,25627,8.3,24.6,0,1577,1583,7407
1979,34,130213,148059,2506042,2452369,19551,13.4,15093,10.3,449384,150545,298839,6.1,18.3,342038,121555,220483,5,13.9,107346,4.4,27.8,0,10295,10322,56858
1979,35,22016,25590,327751,311227,4471,18.3,2309,9.5,78392,31773,46619,10.2,25.2,45343,16743,28600,5.4,14.6,33049,10.6,29.2,0,36,41,832
1979,36,314425,355506,5898843,5829407,43039,12.1,39583,11.2,1017967,316196,701771,5.4,17.5,879094,308833,570261,5.3,15.1,138873,2.4,30.2,0,28950,29064,162524
1979,37,89357,108599,1969001,1910551,15066,14,11909,11.1,338877,114582,224295,6,17.7,221977,85993,135984,4.5,11.6,116900,6.1,23.2,0,8614,8634,44753
1979,38,13973,15791,177763,170166,2263,14.5,1731,11.1,39171,14478,24693,8.5,23,23977,9423,14554,5.5,14.1,15194,8.9,28.2,0,1246,1247,6591
1979,39,156872,195658,3837565,3750740,23967,12.3,20219,10.4,624646,198112,426534,5.3,16.7,450995,168034,282961,4.5,12,173651,4.7,24,0,13348,13400,74907
1979,40,52568,61399,866447,821971,9984,17,4991,8.5,196298,71145,125153,8.7,23.9,107346,36967,70379,4.5,13.1,88952,10.8,26.2,0,91,98,1235
1979,41,51134,59275,872043,834609,10747,18.5,7874,13.6,213014,72124,140890,8.6,25.5,138145,52923,85222,6.3,16.6,74869,8.9,33.2,0,5680,5688,30102
1979,42,178595,214372,4007200,3960793,24802,11.6,21000,9.9,638406,188922,449484,4.8,16.1,545594,175270,370324,4.4,13.8,92812,2.3,27.6,0,14390,14461,78761
1979,44,18273,20277,342377,337806,2451,12.2,1917,9.6,58195,18715,39480,5.5,17.2,49052,14341,34711,4.2,14.5,9143,2.7,29,0,1340,1342,7370
1979,45,44350,53006,963403,938815,7374,14,6155,11.7,163572,51789,111783,5.5,17.4,114395,38282,76113,4.1,12.2,49177,5.2,24.4,0,4523,4557,22195
1979,46,14557,16417,185509,178064,2257,13.9,1868,11.5,39467,14858,24609,8.3,22.2,24577,9904,14673,5.6,13.8,14890,8.4,27.6,0,1327,1328,6139
1979,47,68306,81771,1457872,1421203,11986,14.8,10104,12.5,274564,96506,178058,6.8,19.3,201226,72814,128412,5.1,14.2,73338,5.1,28.4,0,7187,7199,38245
1979,48,228595,282055,4676929,4451203,47590,17.7,22228,8.3,1090434,419040,671394,9.4,24.5,638982,199521,439461,4.5,14.4,451452,10.1,28.8,0,308,381,9442
1979,49,23101,26722,412779,395122,4560,18,2025,8,91787,36997,54790,9.4,23.2,56473,17691,38782,4.5,14.3,35314,8.9,28.6,0,37,41,650
1979,50,11344,12557,164309,160819,1753,14.1,1360,11,30234,10357,19877,6.4,18.8,23254,8177,15077,5.1,14.5,6980,4.3,29,0,1040,1046,5397
1979,51,77100,93949,1551056,1512843,13106,14.1,10377,11.2,287580,99825,187755,6.6,19,211154,73657,137497,4.9,14,76426,5,28,0,7399,7422,37383
1979,53,72969,85408,1218194,1207327,15324,18.3,10892,13,287798,105212,182586,8.7,23.8,266064,98847,167217,8.2,22,21734,1.8,44,0,7480,7512,40436
1979,54,27284,31823,527199,489740,4349,13.8,3581,11.3,132296,28775,103521,5.9,27,57379,20845,36534,4.3,11.7,74917,15.3,23.4,0,2529,2536,10888
1979,55,80177,92794,1622099,1583678,11376,12.4,9199,10,259919,82724,177195,5.2,16.4,183078,63667,119411,4,11.6,76841,4.8,23.2,0,6444,6463,33301
1979,56,10651,11919,139310,132024,2227,19.7,1015,9,35853,15479,20374,11.7,27.2,21281,6545,14736,5,16.1,14572,11.1,32.2,0,25,26,272
1980,01,54494,65852,1080569,1080875,8630,13.1,8426,12.8,179368,61121,118247,5.7,16.6,179982,58053,121929,5.4,16.7,-614,-0.1,33.2,0,6072,6086,33755
1980,02,7082,8324,108319,107880,1477,17.8,1346,16.2,24253,8883,15370,8.2,22.5,23374,7888,15486,7.3,21.7,879,0.8,43.4,0,886,892,4606
1980,04,42362,51152,802680,784645,9389,18.8,6662,13.3,172945,72404,100541,9.2,22,136874,48731,88143,6.2,17.4,36071,4.6,34.8,0,4763,4775,28763
1980,05,36610,41952,620057,610998,5628,13.4,5457,13,112436,36084,76352,5.9,18.4,94317,31904,62413,5.2,15.4,18119,3,30.8,0,3971,3981,17746
1980,06,411314,494149,8242858,8070425,81844,16.8,63887,13.1,1724114,662641,1061473,8.2,21.4,1379247,509990,869257,6.3,17.1,344867,4.3,34.2,0,44372,44573,281515
1980,08,58297,67728,1021282,1001872,11825,17.7,9311,14,211429,85392,126037,8.5,21.1,172609,72878,99731,7.3,17.2,38820,3.9,34.4,0,6583,6606,42218
1980,09,57616,65666,1252462,1230114,7590,11.6,6535,10,193095,60611,132484,4.9,15.7,148398,47871,100527,3.9,12.1,44697,3.6,24.2,0,4554,4595,23569
1980,10,9956,11551,210861,207446,1342,11.6,1316,11.4,31482,11142,20340,5.4,15.2,24652,9206,15446,4.4,11.9,6830,3.3,23.8,0,887,912,4646
1980,11,13573,15600,355893,349621,1882,12.1,1682,10.8,76491,16839,59652,4.8,21.9,63946,30166,33780,8.6,18.3,12545,3.6,36.6,0,1095,1099,7388
1980,12,175454,209305,2967974,2876941,36311,17.7,26348,12.9,654718,281115,373603,9.8,22.8,472652,187917,284735,6.5,16.4,182066,6.4,32.8,0,19499,19564,116237
1980,13,83538,102668,1738130,1717525,14144,13.9,12510,12.3,304619,112458,192161,6.5,17.7,263409,94093,169316,5.5,15.3,41210,2.4,30.6,0,8830,8872,47751
1980,15,16929,20433,304289,301581,3142,15.7,2176,10.9,54569,23490,31079,7.8,18.1,49152,17011,32141,5.6,16.3,5417,1.8,32.6,0,1460,1474,9700
1980,16,17306,20154,247869,260249,3033,15.1,2750,13.7,48592,18415,30177,7.1,18.7,73352,17393,55959,6.7,28.2,-24760,-9.5,37.4,0,1959,1967,9969
1980,17,179908,211082,4184052,4218402,24930,11.8,23577,11.2,585591,214790,370801,5.1,13.9,654292,198851,455441,4.7,15.5,-68701,-1.6,27.8,0,16441,16526,94857
1980,18,81874,99140,1834801,1861237,11525,11.6,10941,11,251482,93016,158466,5,13.5,304355,81446,222909,4.4,16.4,-52873,-2.9,27,0,7641,7676,39265
1980,19,55749,65666,910661,913100,7611,11.6,7178,10.9,135106,49251,85855,5.4,14.8,139984,48068,91916,5.3,15.3,-4878,-0.5,29.6,0,5314,5327,28356
1980,20,46254,54081,754615,749703,6597,12.2,6339,11.7,123471,44071,79400,5.9,16.5,113646,35525,78121,4.7,15.2,9825,1.3,30.4,0,4532,4543,22525
1980,21,51793,61174,1004900,1007266,7362,12,7329,12,156242,54795,101447,5.4,15.5,160973,47030,113943,4.7,16,-4731,-0.5,31,0,5356,5372,27403
1980,22,63552,75731,1248406,1231262,10607,14.1,8772,11.7,244126,84660,159466,6.9,19.8,209838,67600,142238,5.5,17,34288,2.8,34,0,6320,6352,39622
1980,23,19757,22728,318612,317362,2758,12.1,2668,11.7,49996,16786,33210,5.3,15.8,47496,16741,30755,5.3,15,2500,0.8,30,0,1847,1858,8536
1980,24,60838,72838,1297699,1264884,9143,12.6,8028,11.1,251958,102859,149099,8.1,19.9,186327,60600,125727,4.8,14.7,65631,5.2,29.4,0,5417,5452,31888
1980,25,97762,113338,2275489,2239912,12445,11,11065,9.8,373581,108281,265300,4.8,16.7,302427,100621,201806,4.5,13.5,71154,3.2,27,0,7517,7569,48711
1980,26,127753,153767,2884753,2970906,18598,12.1,17456,11.4,375668,145181,230487,4.9,12.6,547974,141696,406278,4.8,18.4,-172306,-5.8,25.2,0,12019,12059,67307
1980,27,70287,82646,1498261,1484861,9964,12.1,8543,10.4,243883,83514,160369,5.6,16.4,217084,72388,144696,4.9,14.6,26799,1.8,29.2,0,5943,5982,39022
1980,28,36518,43031,644850,645528,5817,13.6,5158,12.1,104788,39621,65167,6.1,16.2,106143,34540,71603,5.4,16.4,-1355,-0.2,32.4,0,3773,3796,19808
1980,29,82350,98116,1672736,1676529,11971,12.2,11547,11.8,254355,89912,164443,5.4,15.2,261940,84183,177757,5,15.6,-7585,-0.4,30.4,0,8152,8175,41837
1980,30,17724,20141,218865,223406,2891,14.4,2704,13.4,38298,16849,21449,7.5,17.1,47380,14751,32629,6.6,21.2,-9082,-4.1,34.2,0,1870,1876,9335
1980,31,32400,37353,513125,506666,4429,11.9,4153,11.1,85835,29239,56596,5.8,16.9,72917,23285,49632,4.6,14.4,12918,2.5,28.8,0,2975,2984,14816
1980,32,15355,17631,339283,329669,3431,19.9,2477,14.4,78524,32628,45896,9.9,23.8,59296,22960,36336,7,18,19228,5.8,36,0,1794,1801,16658
1980,33,18005,20158,327736,323960,2553,12.7,2334,11.6,55282,18195,37087,5.6,17.1,47730,17544,30186,5.4,14.7,7552,2.4,29.4,0,1672,1679,9597
1980,34,132229,150343,2543950,2524700,18191,12.2,15533,10.4,410832,136458,274374,5.4,16.3,372331,118888,253443,4.7,14.7,38501,1.6,29.4,0,10873,10914,57552
1980,35,22407,26027,329552,328117,4234,16.4,3553,13.8,67636,29326,38310,8.9,20.6,64765,24492,40273,7.5,19.7,2871,0.9,39.4,0,2525,2529,14673
1980,36,314762,355779,5967801,5918068,40377,11.4,39226,11,967796,314390,653406,5.3,16.4,868329,299762,568567,5.1,14.7,99467,1.7,29.4,0,28818,28890,158956
1980,37,89884,109519,2000591,1988483,13844,12.7,12449,11.4,295466,100393,195073,5,14.9,271251,86634,184617,4.4,13.6,24215,1.3,27.2,0,8888,8926,49223
1980,38,14077,15978,183013,180081,2058,13,1796,11.3,33444,13115,20329,7.3,18.6,27579,9864,17715,5.5,15.3,5865,3.3,30.6,0,1278,1279,6586
1980,39,156831,196098,3777884,3806420,21720,11.1,20491,10.5,521027,180440,340587,4.7,13.7,578098,163195,414903,4.3,15.2,-57071,-1.5,27.4,0,13738,13828,75324
1980,40,53632,62673,906683,885106,9550,15.4,7961,12.8,189186,76640,112546,8.7,21.4,146032,50024,96008,5.7,16.5,43154,4.9,33,0,5882,5909,30204
1980,41,51986,60328,854994,862988,9942,16.6,8601,14.4,163245,67872,95373,7.9,18.9,179232,56721,122511,6.6,20.8,-15987,-1.9,37.8,0,6109,6140,33179
1980,42,178026,214132,4033430,4022847,22704,10.6,22079,10.3,579211,193932,385279,4.8,14.4,558046,187118,370928,4.7,13.9,21165,0.5,27.8,0,15214,15277,86745
1980,44,18311,20297,340773,340926,2176,10.7,2090,10.3,47900,15267,32633,4.5,14,48206,13739,34467,4,14.1,-306,-0.1,28,0,1458,1459,7406
1980,45,44827,53627,970857,966684,7169,13.4,6323,11.9,144146,52465,91681,5.4,14.9,135800,42782,93018,4.4,14,8346,0.9,28,0,4506,4523,21057
1980,46,14648,16540,186819,186117,2057,12.5,1861,11.3,31141,13029,18112,7,16.7,29737,10454,19283,5.6,16,1404,0.7,32,0,1364,1368,6774
1980,47,68649,82403,1435366,1445831,11109,13.5,10164,12.4,224928,85830,139098,5.9,15.6,245857,77243,168614,5.3,17,-20929,-1.4,31.2,0,7236,7251,39818
1980,48,197706,252919,4642986,4604289,28147,10.5,41043,15.3,899084,273070,626014,5.9,19.5,821690,325610,496080,7.1,17.8,77394,1.7,35.6,0,30408,30581,192868
1980,49,23139,26904,420954,416219,4206,15.7,3808,14.2,81420,32823,48597,7.9,19.6,71950,27385,44565,6.6,17.3,9470,2.3,34.6,0,2678,2693,15608
1980,50,11514,12749,169599,166906,1652,13.1,1397,11,28933,9035,19898,5.4,17.3,23547,7223,16324,4.3,14.1,5386,3.2,28.2,0,1056,1058,4549
1980,51,77942,95157,1590951,1569964,12450,13.2,10822,11.4,260508,92235,168273,5.9,16.6,218536,70530,148006,4.5,13.9,41972,2.7,27.8,0,7573,7604,37651
1980,53,73976,86798,1258572,1237123,13661,15.9,11661,13.5,258508,94134,164374,7.6,20.9,215611,75094,140517,6.1,17.4,42897,3.5,34.8,0,8098,8126,43343
1980,54,27159,31783,486921,506848,3750,11.8,3669,11.5,71158,26362,44796,5.2,14,111013,24668,86345,4.9,21.9,-39855,-7.9,28,0,2621,2630,12632
1980,55,80392,93227,1618028,1618761,10351,11.1,9544,10.3,211976,72931,139045,4.5,13.1,213443,66087,147356,4.1,13.2,-1467,-0.1,26.2,0,6749,6781,35373
1980,56,10947,12300,147710,143298,2084,17.2,1608,13.3,34299,13664,20635,9.5,23.9,25475,9642,15833,6.7,17.8,8824,6.1,35.6,0,1172,1175,6648
1981,01,52551,63502,1039172,1049506,7972,12.4,9381,14.6,173810,71309,102501,6.8,16.6,194478,77850,116628,7.4,18.5,-20668,-1.9,33.2,0,6056,6081,37042
1981,02,7104,8283,111713,106881,1480,17.9,1336,16.2,30408,11824,18584,11.1,28.5,20744,8848,11896,8.3,19.4,9664,9.1,38.8,0,748,750,4444
1981,04,42385,51310,805952,797439,8941,17.5,8199,16,164379,68460,95919,8.6,20.6,147352,57838,89514,7.3,18.5,17027,2.1,37,0,5241,5257,30259
1981,05,35019,40278,576127,583058,5424,13.3,6144,15,94704,44911,49793,7.7,16.2,108565,37641,70924,6.5,18.6,-13861,-2.4,32.4,0,4014,4028,19401
1981,06,408274,488896,8228083,8205240,76971,15.7,77407,15.8,1697379,694330,1003049,8.5,20.7,1651693,665325,986368,8.1,20.1,45686,0.6,40.2,0,45626,45863,290518
1981,08,57785,67245,1033387,1017881,11484,17.1,11258,16.7,233658,100146,133512,9.8,23,202646,86744,115902,8.5,19.9,31012,3.1,39.8,0,7006,7037,45832
1981,09,56444,64151,1243234,1240396,7366,11.4,8268,12.8,179079,70315,108764,5.7,14.4,173402,67779,105623,5.5,14,5677,0.4,28,0,4738,4744,25687
1981,10,9706,11249,212954,211575,1280,11.2,1488,13.1,31604,12208,19396,5.8,14.9,28845,10737,18108,5.1,13.6,2759,1.3,27.2,0,839,842,4517
1981,11,13115,15030,348968,354941,1781,11.6,2198,14.4,68654,25259,43395,7.1,19.3,80600,50677,29923,14.3,22.7,-11946,-3.4,38.6,0,1184,1189,12545
1981,12,178244,212419,3076183,3014820,36207,17.2,31440,14.9,693236,286356,406880,9.5,23,570510,234119,336391,7.8,18.9,122726,4.1,37.8,0,20613,20701,120653
1981,13,81987,100899,1730232,1720873,13777,13.6,14441,14.2,323408,131821,191587,7.7,18.8,304690,123359,181331,7.2,17.7,18718,1.1,35.4,0,8847,8869,48297
1981,15,17073,20406,308156,305274,3000,14.7,2850,14,57806,27216,30590,8.9,18.9,52042,20957,31085,6.9,17,5764,1.9,34,0,1700,1733,10583
1981,16,16460,19227,256655,250145,2667,13.6,3213,16.4,61398,36287,25111,14.5,24.5,48377,18565,29812,7.4,19.3,13021,5.2,38.6,0,2057,2077,9980
1981,17,173447,203368,3963351,4025498,23382,11.3,28369,13.7,576838,227322,349516,5.6,14.3,701132,262570,438562,6.5,17.4,-124294,-3.1,28.6,0,16410,16529,109079
1981,18,78583,95289,1740488,1765454,10378,10.7,13009,13.4,248832,95769,153063,5.4,14.1,298764,106961,191803,6.1,16.9,-49932,-2.8,28.2,0,7688,7722,41752
1981,19,53766,63474,857548,872749,7035,10.9,8526,13.2,133738,68295,65443,7.8,15.3,164139,64448,99691,7.4,18.8,-30401,-3.5,30.6,0,5316,5338,25683
1981,20,45126,52682,737691,739441,6710,12.6,7473,14,121711,55555,66156,7.5,16.5,125210,47525,77685,6.4,16.9,-3499,-0.4,33,0,4605,4625,24088
1981,21,49848,58912,933447,944698,6978,11.7,8213,13.8,145590,58431,87159,6.2,15.4,168093,59346,108747,6.3,17.8,-22503,-2.4,30.8,0,5102,5119,26963
1981,22,63310,75338,1282024,1259344,10629,14.1,10254,13.6,264401,101116,163285,8,21,219040,82248,136792,6.5,17.4,45361,3.6,34.8,0,6453,6491,39080
1981,23,19128,21998,311616,311506,2611,11.7,3003,13.5,50547,17665,32882,5.7,16.2,50327,20827,29500,6.7,16.2,220,0,32.4,0,1849,1858,8441
1981,24,59739,71488,1260969,1275299,8897,12.3,9797,13.6,214194,86602,127592,6.8,16.8,242854,85161,157693,6.7,19,-28660,-2.2,33.6,0,5568,5591,32202
1981,25,96214,111344,2259096,2260249,12150,10.8,13281,11.8,367219,125367,241852,5.5,16.2,369526,156298,213228,6.9,16.3,-2307,-0.1,32.4,0,7436,7478,57603
1981,26,123243,147901,2739942,2802878,17059,11.3,21384,14.2,385837,164571,221266,5.9,13.8,511709,184908,326801,6.6,18.3,-125872,-4.5,27.6,0,12000,12080,65260
1981,27,68780,80765,1454775,1463405,9428,11.6,10300,12.6,236686,98844,137842,6.8,16.2,253946,97186,156760,6.6,17.4,-17260,-1.2,32.4,0,5945,5974,41864
1981,28,35092,41408,597037,601942,5057,12,6053,14.4,94785,36504,58281,6.1,15.7,104595,36934,67661,6.1,17.4,-9810,-1.7,31.4,0,3941,3949,19855
1981,29,79623,94775,1617096,1622808,11598,12.1,13557,14.1,259294,102839,156455,6.3,16,270718,103489,167229,6.4,16.7,-11424,-0.7,32,0,8124,8151,41830
1981,30,17112,19422,199507,200481,2734,14,2907,14.8,37988,15830,22158,7.9,18.9,39936,17336,22600,8.6,19.9,-1948,-1,37.8,0,1814,1814,9491
1981,31,30846,35583,484418,482591,4092,11.4,4785,13.3,82415,33029,49386,6.8,17.1,78760,31669,47091,6.6,16.3,3655,0.8,32.6,0,2813,2818,13933
1981,32,15347,17668,332581,334726,3230,18.3,2985,16.9,70405,30682,39723,9.2,21,74695,28250,46445,8.4,22.3,-4290,-1.3,42,0,1861,1865,11907
1981,33,17549,19671,319365,317448,2597,13.1,2699,13.6,58487,21577,36910,6.8,18.4,54653,23154,31499,7.3,17.2,3834,1.2,34.4,0,1636,1639,8820
1981,34,129561,147107,2525416,2514843,17249,11.6,19125,12.9,430120,164498,265622,6.5,17.1,408975,166423,242552,6.6,16.3,21145,0.8,32.6,0,11362,11404,58814
1981,35,22018,25535,327952,325449,3923,15.2,4092,15.9,70567,29721,40846,9.1,21.7,65561,27636,37925,8.5,20.1,5006,1.6,40.2,0,2629,2639,15593
1981,36,307251,346538,5835836,5862840,38945,11.1,45640,13,956964,342525,614439,5.8,16.3,1010973,403483,607490,6.9,17.2,-54009,-0.9,32.6,0,28454,28579,155841
1981,37,87816,107193,1964589,1966888,13278,12.3,14688,13.6,297666,116106,181560,5.9,15.1,302265,117400,184865,6,15.4,-4599,-0.3,30.2,0,9063,9091,49490
1981,38,13541,15447,169550,170036,1969,12.7,2036,13.1,28596,12930,15666,7.6,16.8,29567,10886,18681,6.4,17.4,-971,-0.6,33.6,0,1252,1253,6111
1981,39,151532,189344,3538692,3615444,20338,10.6,25160,13.1,462185,188313,273872,5.2,12.8,615689,222057,393632,6.1,17,-153504,-4.2,25.6,0,13901,13973,77288
1981,40,53266,62109,916598,894851,9586,15.4,9200,14.8,193706,79984,113722,8.9,21.6,150212,65049,85163,7.3,16.8,43494,4.8,33.6,0,6098,6113,32564
1981,41,50412,58527,796437,812999,9010,15.2,9905,16.7,136940,66356,70584,8.2,16.8,170063,67923,102140,8.4,20.9,-33123,-4.1,33.6,0,6146,6168,34569
1981,42,170981,206089,3960673,3985643,20903,10,26660,12.7,575972,230610,345362,5.8,14.5,625911,230928,394983,5.8,15.7,-49939,-1.2,29,0,15340,15409,89073
1981,44,17847,19791,334419,337114,2144,10.7,2490,12.4,49598,19112,30486,5.7,14.7,54987,21114,33873,6.3,16.3,-5389,-1.6,29.4,0,1480,1484,8297
1981,45,43447,52240,949443,952226,6773,12.8,7641,14.5,142786,57611,85175,6.1,15,148352,58409,89943,6.1,15.6,-5566,-0.6,30,0,4654,4671,26123
1981,46,13981,15802,169149,171563,1762,11,2150,13.4,25092,11275,13817,6.6,14.6,29920,11494,18426,6.7,17.4,-4828,-2.8,29.2,0,1332,1336,6566
1981,47,66187,79665,1399646,1403176,10105,12.5,11619,14.4,226198,87817,138381,6.3,16.1,233257,89695,143562,6.4,16.6,-7059,-0.5,32.2,0,7416,7445,41705
1981,48,235071,291027,5034784,4879338,52884,19.5,34927,12.9,1096543,500349,596194,10.3,22.5,785653,310737,474916,6.4,16.1,310890,6.4,32.2,0,19810,19910,130880
1981,49,22649,26560,416591,416596,4227,15.8,4266,16,79974,36675,43299,8.8,19.2,79983,33316,46667,8,19.2,-9,0,38.4,0,2642,2654,16753
1981,50,11049,12252,161839,161293,1531,12.4,1681,13.6,25057,8699,16358,5.4,15.5,23964,9323,14641,5.8,14.9,1093,0.6,29.8,0,1057,1061,5075
1981,51,76139,93322,1600657,1586248,12065,12.8,13047,13.9,286626,120522,166104,7.6,18.1,257808,110576,147232,7,16.3,28818,1.8,32.6,0,7757,7805,46449
1981,53,72257,84939,1218382,1222439,12573,14.7,13197,15.4,230519,97017,133502,7.9,18.9,238633,88570,150063,7.2,19.5,-8114,-0.6,37.8,0,7886,7920,41059
1981,54,26008,30615,467455,471844,3614,11.6,4368,14.1,70325,29683,40642,6.3,14.9,79104,29224,49880,6.2,16.8,-8779,-1.9,29.8,0,2784,2787,13077
1981,55,78256,90700,1536799,1562754,9715,10.6,11341,12.4,203086,84137,118949,5.4,13,254997,83001,171996,5.3,16.3,-51911,-3.3,26,0,6512,6536,33536
1981,56,11025,12419,152155,149044,2130,17.3,1889,15.3,36862,14592,22270,9.8,24.7,30639,11469,19170,7.7,20.6,6223,4.1,41.2,0,1229,1232,6489
1982,01,51528,63550,1032118,1035586,8770,13.8,7905,12.4,177484,73771,103713,7.1,17.1,184421,62802,121619,6.1,17.8,-6937,-0.7,34.2,0,4763,4766,27015
1982,02,7770,9202,126497,118895,2062,23.6,1113,12.7,40708,17287,23421,14.5,34.2,25503,9822,15681,8.3,21.5,15205,12.7,43,0,578,581,5306
1982,04,44307,54704,817824,810479,11014,20.8,7184,13.5,183708,97137,86571,12,22.7,169018,56252,112766,6.9,20.9,14690,1.8,41.8,0,3976,3983,23401
1982,05,34933,40902,573770,574437,6305,15.5,5165,12.7,99784,43730,56054,7.6,17.4,101117,33088,68029,5.8,17.6,-1333,-0.2,34.8,0,3055,3059,16426
1982,06,416159,507962,8511604,8361841,87529,17.5,63168,12.7,1880514,887957,992557,10.6,22.5,1580990,528202,1052788,6.3,18.9,299524,3.6,37.8,0,34915,34960,231250
1982,08,60030,71120,1126289,1079447,13933,20.1,9428,13.6,290823,159697,131126,14.8,26.9,197139,76716,120423,7.1,18.3,93684,8.6,36.6,0,5138,5142,32193
1982,09,57543,66275,1259325,1250950,8917,13.7,6249,9.6,193443,85654,107789,6.8,15.5,176693,51129,125564,4.1,14.1,16750,1.4,28.2,0,3650,3654,22434
1982,10,9918,11554,216042,214437,1583,13.9,1181,10.4,30610,13545,17065,6.3,14.3,27400,8755,18645,4.1,12.8,3210,1.5,25.6,0,654,658,3178
1982,11,13524,15582,335086,337053,2403,15.7,1738,11.3,60513,32202,28311,9.6,18,64447,18749,45698,5.6,19.1,-3934,-1.1,36,0,895,899,7992
1982,12,185530,224964,3140699,3106680,41962,19.2,27844,12.7,682633,330673,351960,10.6,22,614597,207785,406812,6.7,19.8,68036,2.2,39.6,0,16531,16557,107630
1982,13,82630,103586,1766363,1746660,16197,15.8,12492,12.2,334572,164650,169922,9.4,19.2,295166,98190,196976,5.6,16.9,39406,2.3,33.8,0,6854,6859,42263
1982,15,17274,21094,314153,311254,3292,15.9,2380,11.5,60534,33667,26867,10.8,19.4,54737,18882,35855,6.1,17.6,5797,1.8,35.2,0,1355,1355,8406
1982,16,16468,19544,243120,249562,3163,16.3,2591,13.4,52818,33498,19320,13.4,21.2,65702,15771,49931,6.3,26.3,-12884,-5.1,42.4,0,1409,1410,7452
1982,17,174328,207478,3891660,3926601,28342,13.8,22357,10.9,607604,289970,317634,7.4,15.5,677485,206379,471106,5.3,17.3,-69881,-1.8,31,0,12810,12830,79738
1982,18,78792,97057,1704572,1722512,12672,13.2,10134,10.5,237561,104209,133352,6,13.8,273441,76137,197304,4.4,15.9,-35880,-2.1,27.6,0,6026,6046,33864
1982,19,52350,62933,868448,862235,7812,12.4,7275,11.5,157013,65929,91084,7.6,18.2,144589,45273,99316,5.3,16.8,12424,1.4,33.6,0,4286,4287,20707
1982,20,45119,53521,747000,741914,7796,14.7,6269,11.8,132145,57443,74702,7.7,17.8,121973,43734,78239,5.9,16.4,10172,1.4,32.8,0,3726,3748,22239
1982,21,50098,60158,944667,938637,8804,14.8,6926,11.6,167238,76129,91109,8.1,17.8,155179,47220,107959,5,16.5,12059,1.3,33,0,4166,4169,21752
1982,22,65758,79316,1316464,1297744,13262,17.1,8662,11.2,277603,115912,161691,8.9,21.4,240163,82782,157381,6.4,18.5,37440,2.9,37,0,4922,4939,38950
1982,23,19071,22254,313883,312392,3004,13.6,2481,11.2,53643,23931,29712,7.7,17.2,50661,19425,31236,6.2,16.2,2982,1,32.4,0,1444,1451,9929
1982,24,60832,74008,1278620,1269528,10849,14.9,7703,10.6,227384,104776,122608,8.3,17.9,209199,64953,144246,5.1,16.5,18185,1.4,33,0,4264,4266,26947
1982,25,98088,115290,2325308,2299675,15237,13.4,10541,9.3,364593,151188,213405,6.6,15.9,313327,93675,219652,4.1,13.6,51266,2.3,27.2,0,5950,5956,41290
1982,26,122650,150153,2635254,2686353,20280,13.6,16693,11.2,379305,164916,214389,6.1,14.1,481502,146863,334639,5.5,17.9,-102197,-3.8,28.2,0,9214,9227,55876
1982,27,68678,82181,1434171,1443395,10889,13.4,8522,10.5,227540,96515,131025,6.7,15.8,245988,69733,176255,4.8,17,-18448,-1.2,31.6,0,4801,4811,28508
1982,28,34671,41638,583779,589624,5936,14.3,5006,12.1,88078,41851,46227,7.1,14.9,99768,33064,66704,5.6,16.9,-11690,-2,29.8,0,2957,2959,14331
1982,29,78840,95517,1656109,1633451,13306,14,11294,11.9,304429,155239,149190,9.5,18.6,259114,86411,172703,5.3,15.9,45315,2.7,31.8,0,6521,6540,37397
1982,30,17059,19628,199520,198950,3054,15.6,2501,12.8,41121,20141,20980,10.1,20.7,39981,13653,26328,6.9,20.1,1140,0.6,40.2,0,1433,1436,8010
1982,31,30581,35790,478071,480356,4735,13.3,3890,10.9,75015,34441,40574,7.2,15.6,79584,24957,54627,5.2,16.6,-4569,-1,31.2,0,2348,2351,12182
1982,32,15935,18664,338302,335154,3692,20.3,2505,13.8,76613,38523,38090,11.5,22.9,70316,23504,46812,7,21,6297,1.9,42,0,1405,1406,10635
1982,33,17903,20303,330018,326759,3047,15.2,2178,10.9,54362,22836,31526,7,16.6,47844,16782,31062,5.1,14.6,6518,2,29.2,0,1280,1281,8359
1982,34,131665,151014,2573185,2548151,20644,13.8,15539,10.4,456701,176682,280019,6.9,17.9,406633,140613,266020,5.5,16,50068,1.9,32,0,8811,8820,50131
1982,35,22552,26589,340467,334673,4549,17.4,3231,12.4,73314,33842,39472,10.1,21.9,61726,23111,38615,6.9,18.4,11588,3.5,36.8,0,1887,1887,11252
1982,36,310148,353411,5971236,5902562,46816,13.4,36881,10.5,1019131,426999,592132,7.2,17.3,881783,296624,585159,5,14.9,137348,2.4,29.8,0,22083,22112,130311
1982,37,88660,109820,1977923,1968928,15526,14.3,11811,10.9,304547,141191,163356,7.2,15.5,286557,90994,195563,4.6,14.6,17990,0.9,29.2,0,7290,7305,39094
1982,38,13516,15679,174006,171412,2209,14.2,1713,11,31243,13945,17298,8.1,18.2,26054,8775,17279,5.1,15.2,5189,3,30.4,0,983,984,5189
1982,39,150716,191602,3477042,3506120,24446,12.8,20170,10.6,516297,225909,290388,6.4,14.7,574453,164297,410156,4.7,16.4,-58156,-1.7,29.4,0,10913,10930,66014
1982,40,55975,66082,979305,947988,12114,18.9,7613,11.9,223683,97440,126243,10.3,23.6,161048,57888,103160,6.1,17,62635,6.6,34,0,4621,4623,28930
1982,41,49241,58378,775928,784462,9608,16.4,8931,15.3,152723,75413,77310,9.6,19.5,169790,56122,113668,7.2,21.6,-17067,-2.1,39,0,4952,4970,27160
1982,42,170926,209563,3936367,3945137,26202,12.6,20407,9.8,614705,255840,358865,6.5,15.6,632244,185545,446699,4.7,16,-17539,-0.4,31.2,0,11471,11502,71537
1982,44,17894,20031,328940,331141,2462,12.4,2061,10.3,47207,20312,26895,6.1,14.3,51609,15246,36363,4.6,15.6,-4402,-1.3,28.6,0,1205,1206,7347
1982,45,43950,53821,925360,922082,8233,15.5,6102,11.5,152251,74337,77914,8.1,16.5,145695,44066,101629,4.8,15.8,6556,0.7,31.6,0,3772,3776,23598
1982,46,13678,15664,167274,167378,1951,12.4,1742,11.1,27382,13079,14303,7.8,16.4,27589,9235,18354,5.5,16.5,-207,-0.1,32.8,0,1050,1051,5099
1982,47,66172,81133,1390208,1394634,12316,15.3,9901,12.3,229135,110897,118238,8,16.4,237988,71588,166400,5.1,17.1,-8853,-0.7,32.8,0,5818,5825,34291
1982,48,247519,312446,5380004,5202200,58523,19.4,34608,11.5,1257977,582424,675553,11.2,24.2,902370,315634,586736,6.1,17.3,355607,6.9,34.6,0,20275,20292,141169
1982,49,22985,27573,425165,420674,4842,17.9,3523,13,84440,38779,45661,9.2,20.1,75458,26666,48792,6.3,17.9,8982,2.2,35.8,0,1980,1980,13106
1982,50,11298,12644,162510,162040,1891,15.2,1340,10.8,25915,10823,15092,6.7,16,24975,9014,15961,5.6,15.4,940,0.6,30.8,0,790,803,4287
1982,51,76933,96007,1626347,1614790,14270,15.1,10560,11.1,296732,120466,176266,7.5,18.4,273619,80069,193550,5,16.9,23113,1.5,33.8,0,6049,6053,35442
1982,53,73192,87671,1203225,1210293,14841,17.2,10965,12.7,223705,110239,113466,9.1,18.5,237841,72311,165530,6,19.7,-14136,-1.2,37,0,6136,6158,34735
1982,54,25339,30396,463251,464766,4211,13.8,3816,12.5,75807,33940,41867,7.3,16.3,78839,27910,50929,6,17,-3032,-0.7,32.6,0,2184,2185,12243
1982,55,78176,92160,1534807,1533863,11980,13.1,9241,10.1,225254,102851,122403,6.7,14.7,223366,65090,158276,4.2,14.6,1888,0.1,29.2,0,5364,5373,28417
1982,56,11398,13087,160822,156246,2489,19.5,1681,13.2,42591,23952,18639,15.3,27.3,33439,10923,22516,7,21.4,9152,5.9,42.8,0,981,981,5404
1983,01,52559,64548,998378,1008350,7818,12.2,7383,11.5,168318,68404,99914,6.8,16.7,188262,63721,124541,6.3,18.7,-19944,-2,33.4,0,4861,4884,28672
1983,02,8798,10380,130283,128659,2259,23.1,1221,12.5,35360,15783,19577,12.3,27.5,32111,10660,21451,8.3,25,3249,2.5,50,0,757,757,4841
1983,04,46545,57195,834075,822756,9435,16.9,7192,12.9,185788,80718,105070,9.8,22.6,163150,53973,109177,6.6,19.8,22638,2.8,39.6,0,4743,4763,29774
1983,05,35923,41871,571932,570494,5448,13.2,4814,11.6,94336,37684,56652,6.6,16.5,91460,29320,62140,5.1,16,2876,0.5,32,0,3353,3361,16481
1983,06,426462,517992,8177494,8321084,70793,13.8,63438,12.4,1560532,599820,960712,7.2,18.8,1847713,564210,1283503,6.8,22.2,-287181,-3.4,37.6,0,39906,40136,249852
1983,08,62282,73644,1063108,1088757,11852,16.4,9693,13.4,211200,93647,117553,8.6,19.4,262498,72534,189964,6.7,24.1,-51298,-4.7,38.8,0,6409,6438,37759
1983,09,59291,68139,1263220,1261708,7543,11.2,6203,9.2,192095,61693,130402,4.9,15.2,189072,52247,136825,4.1,15,3023,0.2,30,0,4048,4055,21376
1983,10,10295,11941,217241,216723,1439,12.3,1171,10,32890,13261,19629,6.1,15.2,31854,10263,21591,4.7,14.7,1036,0.5,29.4,0,710,715,4373
1983,11,14133,16174,361127,347245,2028,12.8,1581,10,77687,19080,58607,5.5,22.4,49923,15441,34482,4.4,14.4,27764,8,28.8,0,963,965,6655
1983,12,190507,230989,3144347,3139059,36827,16.2,31999,14,628242,274794,353448,8.8,20,617665,233193,384472,7.4,19.7,10577,0.3,39.4,0,19819,19900,117227
1983,13,86232,107526,1770293,1761597,14892,14.1,11578,11,322636,129884,192752,7.4,18.3,305243,99959,205284,5.7,17.3,17393,1,34.6,0,7611,7628,45682
1983,15,17978,21839,310914,313054,2793,13,2259,10.5,53512,21579,31933,6.9,17.1,57791,17948,39843,5.7,18.5,-4279,-1.4,34.2,0,1493,1514,9973
1983,16,16851,19897,230176,235298,2607,13.2,2413,12.2,40967,16777,24190,7.1,17.4,51212,15055,36157,6.4,21.8,-10245,-4.4,34.8,0,1604,1611,8259
1983,17,171918,205087,3716333,3800343,22707,11,25620,12.4,527344,202279,325065,5.3,13.9,695365,229375,465990,6,18.3,-168021,-4.4,27.8,0,14010,14109,86046
1983,18,74718,92676,1614399,1656094,9691,10.2,13097,13.8,219415,74920,144495,4.5,13.2,302805,108794,194011,6.6,18.3,-83390,-5.1,26.4,0,7057,7108,41432
1983,19,53389,63885,800282,832149,6400,10.1,6389,10.1,120457,51006,69451,6.1,14.5,184191,51742,132449,6.2,22.1,-63734,-7.6,29,0,4296,4306,21445
1983,20,46404,54762,707548,724018,6689,12.4,5902,10.9,112031,47699,64332,6.6,15.5,144970,49222,95748,6.8,20,-32939,-4.5,31,0,3966,3987,20525
1983,21,51207,61174,903965,923725,7339,12.1,6809,11.2,136240,55409,80831,6,14.7,175761,52529,123232,5.7,19,-39521,-4.3,29.4,0,4613,4623,26748
1983,22,67495,80869,1214181,1260193,10466,13.1,9369,11.7,211564,86100,125464,6.8,16.8,303587,91104,212483,7.2,24.1,-92023,-7.3,33.6,0,6431,6452,46244
1983,23,19672,22809,319048,316502,2679,11.9,2292,10.2,48629,17911,30718,5.7,15.4,43537,15757,27780,5,13.8,5092,1.6,27.6,0,1475,1478,7526
1983,24,63676,76930,1294096,1287630,9547,12.7,7238,9.6,212354,73410,138944,5.7,16.5,199422,65692,133730,5.1,15.5,12932,1,31,0,4650,4677,28239
1983,25,100925,118300,2336720,2331911,12775,10.9,10533,9,346813,123386,223427,5.3,14.9,337195,99420,237775,4.3,14.5,9618,0.4,29,0,6891,6921,46491
1983,26,125642,153082,2612859,2630357,17284,11.4,15652,10.3,368399,132359,236040,5,14,403395,122734,280661,4.7,15.3,-34996,-1.3,28,0,9722,9780,55747
1983,27,70589,84129,1402368,1414329,9302,11.2,8050,9.7,214293,82139,132154,5.8,15.2,238216,69319,168897,4.9,16.8,-23923,-1.6,30.4,0,5104,5123,31334
1983,28,35577,42476,572838,574022,5121,12.2,4724,11.2,93681,39222,54459,6.8,16.3,96048,30367,65681,5.3,16.7,-2367,-0.4,32.6,0,3262,3279,16513
1983,29,81397,97812,1589808,1615228,11785,12.2,10396,10.8,258197,101147,157050,6.3,16,309038,94010,215028,5.8,19.1,-50841,-3.1,32,0,6682,6724,37811
1983,30,17739,20302,196162,196569,2735,13.7,2310,11.6,38067,17462,20605,8.9,19.4,38881,13198,25683,6.7,19.8,-814,-0.4,38.8,0,1516,1531,8733
1983,31,31505,36662,467803,470496,3923,10.8,3578,9.9,75529,32518,43011,6.9,16.1,80915,26235,54680,5.6,17.2,-5386,-1.1,32.2,0,2302,2312,13286
1983,32,16170,18897,326568,332451,2837,15.1,2678,14.3,57379,26166,31213,7.9,17.3,69145,21842,47303,6.6,20.8,-11766,-3.5,34.6,0,1784,1789,11403
1983,33,18710,21156,335827,332368,2759,13.3,2048,9.9,57276,21021,36255,6.3,17.2,50358,16168,34190,4.9,15.2,6918,2,30.4,0,1397,1399,8668
1983,34,135767,155125,2608074,2592664,18127,11.8,15163,9.9,445756,156990,288766,6.1,17.2,414935,146793,268142,5.7,16,30821,1.2,32,0,9895,9916,55193
1983,35,23525,27583,333200,333916,4074,15,3327,12.3,68551,31265,37286,9.4,20.5,69983,24770,45213,7.4,21,-1432,-0.5,41,0,2169,2172,13358
1983,36,318787,362165,5961810,5966648,41467,11.6,36329,10.2,961382,317954,643428,5.3,16.1,971057,306263,664794,5.1,16.3,-9675,-0.2,32.2,0,25487,25565,144363
1983,37,84963,106262,1943024,1951673,12413,11.5,14724,13.6,292264,116714,175550,6,15,309562,110138,199424,5.6,15.9,-17298,-0.9,30,0,8045,8088,44571
1983,38,13888,16016,169651,171271,1812,11.4,1696,10.7,27077,11346,15731,6.6,15.8,30316,11141,19175,6.5,17.7,-3239,-1.9,31.6,0,1124,1127,6348
1983,39,153324,193626,3379638,3429360,19593,10.2,19322,10,465437,167402,298035,4.9,13.6,564881,153146,411735,4.5,16.5,-99444,-2.9,27.2,0,11696,11777,67892
1983,40,56795,66872,910722,938901,9261,13.9,8770,13.2,168112,73567,94545,7.8,17.9,224470,67259,157211,7.2,23.9,-56358,-6,35.8,0,6372,6394,41004
1983,41,50079,59185,741842,756681,8048,13.7,7693,13.1,132942,53820,79122,7.1,17.6,162619,47430,115189,6.3,21.5,-29677,-3.9,35.2,0,4962,4991,26424
1983,42,175213,213454,3780537,3858567,21723,10.3,20017,9.5,535545,199683,335862,5.2,13.9,691606,190734,500872,4.9,17.9,-156061,-4,27.8,0,12337,12399,73810
1983,44,18301,20378,332138,330649,2128,10.5,1917,9.5,46683,14197,32486,4.3,14.1,43705,13866,29839,4.2,13.2,2978,0.9,26.4,0,1294,1296,6785
1983,45,42225,52201,896498,906297,6290,11.9,7249,13.7,134507,53293,81214,5.9,14.8,154104,52414,101690,5.8,17,-19597,-2.2,29.6,0,4240,4254,24142
1983,46,14024,15956,165543,166127,1719,10.9,1687,10.7,25286,10540,14746,6.3,15.2,26453,9057,17396,5.5,15.9,-1167,-0.7,30.4,0,1076,1080,5293
1983,47,68003,82972,1402283,1390395,10688,13,9477,11.6,245978,99175,146803,7.1,17.7,222202,69097,153105,5,16,23776,1.7,32,0,6328,6359,36869
1983,48,256749,322516,5140323,5235620,48407,15.3,40083,12.6,1024818,444880,579938,8.5,19.6,1215413,359445,855968,6.9,23.2,-190595,-3.6,39.2,0,26952,27194,183673
1983,49,23460,28098,418079,420041,3739,13.4,3502,12.6,77471,34207,43264,8.1,18.4,81394,25592,55802,6.1,19.4,-3923,-1,36.8,0,2234,2241,13967
1983,50,11688,13024,161519,162155,1585,12.4,1325,10.3,22244,8657,13587,5.3,13.7,23515,6270,17245,3.9,14.5,-1271,-0.8,27.4,0,902,904,3849
1983,51,80067,99284,1619705,1622507,12244,12.5,9888,10.1,259447,91007,168440,5.6,16,265051,76382,188669,4.7,16.3,-5604,-0.3,32,0,6442,6492,36726
1983,53,76292,90803,1220073,1210142,12758,14.3,10543,11.8,240551,112306,128245,9.3,19.9,220688,66949,153739,5.5,18.2,19863,1.7,36.4,0,6727,6784,36932
1983,54,25750,30779,422514,443563,3385,11.1,3516,11.5,55566,25529,30037,5.8,12.5,97665,25622,72043,5.8,22,-42099,-9.5,25,0,2316,2320,12624
1983,55,80231,94261,1491805,1514579,9617,10.3,8566,9.2,198167,71956,126211,4.8,13.1,243714,64074,179640,4.2,16.1,-45547,-3,26.2,0,5439,5461,31441
1983,56,11467,13117,134229,146464,1855,14.2,1917,14.6,25457,12989,12468,8.9,17.4,49927,12160,37767,8.3,34.1,-24470,-16.7,34.8,0,1309,1310,7754
1984,01,55138,67233,1078649,1040328,10032,15.2,7408,11.2,214207,74882,139325,7.2,20.6,137565,56023,81542,5.4,13.2,76642,7.4,26.4,0,4888,4910,28444
1984,02,9721,11362,140970,135862,2456,22.6,1459,13.4,37446,16633,20813,12.2,27.6,27231,10328,16903,7.6,20,10215,7.6,40,0,901,902,5761
1984,04,49990,60964,935713,886564,10981,18.6,7237,12.3,230877,88592,142285,10,26,132578,50448,82130,5.7,15,98299,11,30,0,4630,4652,27226
1984,05,37626,43722,614050,591885,6764,15.8,4944,11.6,119763,42642,77121,7.2,20.2,75432,30823,44609,5.2,12.7,44331,7.5,25.4,0,3360,3379,16933
1984,06,444670,537786,8836751,8501049,81523,15.4,61524,11.7,1942412,683957,1258455,8,22.8,1271009,478894,792115,5.6,15,671403,7.8,30,0,38298,38462,232832
1984,08,65539,77255,1128637,1095963,13247,17.6,9734,12.9,245645,101925,143720,9.3,22.4,180297,67139,113158,6.1,16.5,65348,5.9,33,0,6474,6496,35849
1984,09,61305,70362,1323743,1292967,8572,12.4,6358,9.2,223781,74194,149587,5.7,17.3,162228,54138,108090,4.2,12.5,61553,4.8,25,0,4186,4197,24915
1984,10,10613,12270,230863,223808,1626,13.4,1297,10.7,40634,13713,26921,6.1,18.2,26523,9639,16884,4.3,11.9,14111,6.3,23.8,0,779,782,3757
1984,11,13793,15913,347020,353491,1873,11.7,2071,12.9,56409,19600,36809,5.5,16,69351,18006,51345,5.1,19.6,-12942,-3.6,32,0,1173,1173,6855
1984,12,204982,247109,3493856,3320817,44838,18.8,28709,12,839620,356722,482898,10.7,25.3,493543,197497,296046,5.9,14.9,346077,10.4,29.8,0,19564,19669,108460
1984,13,90975,112875,1933711,1852078,17152,15.6,11954,10.8,389921,142143,247778,7.7,21.1,226655,91212,135443,4.9,12.2,163266,8.9,24.4,0,7527,7556,45174
1984,15,17969,21828,310809,310797,2526,11.6,2523,11.6,49153,18100,31053,5.8,15.8,49128,17582,31546,5.7,15.8,25,0,31.6,0,1549,1581,8836
1984,16,17361,20481,248125,239238,2870,14.2,2292,11.4,52165,17990,34175,7.5,21.8,34391,13559,20832,5.7,14.4,17774,7.4,28.8,0,1562,1565,8122
1984,17,180753,214659,3974748,3851622,27776,13.2,19475,9.3,710217,237850,472367,6.2,18.4,463966,164385,299581,4.3,12,246251,6.4,24,0,10288,10338,52728
1984,18,82032,100417,1747128,1684517,12219,12.7,6396,6.6,316793,110863,205930,6.6,18.8,191571,67623,123948,4,11.4,125222,7.4,22.8,0,154,177,1833
1984,19,54248,64905,826660,813190,7685,11.9,6643,10.3,137026,51683,85343,6.4,16.9,110086,37539,72547,4.6,13.5,26940,3.4,27,0,4428,4440,20054
1984,20,47008,55572,776793,742495,7850,14.2,7105,12.9,173405,53604,119801,7.2,23.4,104808,45527,59281,6.1,14.1,68597,9.3,28.2,0,4155,4165,22608
1984,21,52680,62833,946936,926022,8716,14.1,7019,11.3,164634,61879,102755,6.7,17.8,122805,48435,74370,5.2,13.3,41829,4.5,26.6,0,4725,4734,27193
1984,22,68750,82544,1234961,1226034,11552,14.1,9918,12.1,229783,89425,140358,7.3,18.7,211928,73874,138054,6,17.3,17855,1.4,34.6,0,6603,6629,36860
1984,23,20624,23857,337710,327997,3324,14.3,2223,9.5,56536,19436,37100,5.9,17.2,37111,13102,24009,4,11.3,19425,5.9,22.6,0,1444,1452,6650
1984,24,63699,77363,1380689,1335248,9621,12.5,9056,11.7,261963,98263,163700,7.4,19.6,171080,70982,100098,5.3,12.8,90883,6.8,25.6,0,5195,5214,30943
1984,25,104727,122586,2513464,2430899,14760,12.3,10642,8.8,443616,139131,304485,5.7,18.2,278485,91928,186557,3.8,11.5,165131,6.7,23,0,6883,6898,41653
1984,26,130947,158621,2789803,2682072,20564,13.2,15346,9.8,513418,158996,354422,5.9,19.1,297955,126626,171329,4.7,11.1,215463,8,22.2,0,9657,9713,51279
1984,27,73463,87209,1510482,1456843,11483,13.4,8475,9.9,286783,98644,188139,6.8,19.7,179506,70081,109425,4.8,12.3,107277,7.4,24.6,0,5380,5429,32224
1984,28,36901,43906,613532,592868,6232,14.4,4867,11.3,115180,41264,73916,7,19.4,73852,30191,43661,5.1,12.5,41328,6.9,25,0,3259,3270,14956
1984,29,83049,99775,1697908,1652924,13227,13.4,11513,11.6,312572,111525,201047,6.7,18.9,222604,82694,139910,5,13.5,89968,5.4,27,0,7251,7280,42204
1984,30,18551,21143,201311,198664,3215,15.5,2377,11.5,38138,15372,22766,7.7,19.2,32844,11707,21137,5.9,16.5,5294,2.7,33,0,1552,1555,6989
1984,31,31279,36541,478597,476473,4242,11.6,4368,11.9,77321,29588,47733,6.2,16.2,73072,27182,45890,5.7,15.3,4249,0.9,30.6,0,2538,2550,12842
1984,32,17171,20005,361588,343825,3528,18.1,2413,12.4,83353,28885,54468,8.4,24.2,47827,20059,27768,5.8,13.9,35526,10.3,27.8,0,1581,1581,9125
1984,33,19940,22503,370940,350221,3475,15.9,2147,9.8,80223,29749,50474,8.5,22.9,38784,16317,22467,4.7,11.1,41439,11.8,22.2,0,1426,1431,7893
1984,34,139819,159770,2757056,2680205,20007,12.7,15534,9.9,510056,179469,330587,6.7,19,356355,125343,231012,4.7,13.3,153701,5.7,26.6,0,10004,10026,54110
1984,35,24339,28441,352773,343775,4472,16,3567,12.7,76204,32475,43729,9.4,22.2,58208,21059,37149,6.1,16.9,17996,5.3,33.8,0,2361,2366,12325
1984,36,325043,368867,6207456,6097225,44945,12.3,38364,10.5,1058653,371141,687512,6.1,17.4,838190,286843,551347,4.7,13.7,220463,3.7,27.4,0,26257,26302,161909
1984,37,97433,119472,2134763,2037736,17575,15.6,6616,5.9,387849,127451,260398,6.3,19,193797,55613,138184,2.7,9.5,194052,9.5,19,0,230,239,1749
1984,38,14104,16305,174294,172112,2072,12.8,1820,11.3,29604,12192,17412,7.1,17.2,25240,9896,15344,5.7,14.7,4364,2.5,29.4,0,1054,1057,5056
1984,39,158035,198456,3569587,3475636,23392,11.9,18807,9.6,594895,193324,401571,5.6,17.1,406993,135450,271543,3.9,11.7,187902,5.4,23.4,0,11407,11499,56969
1984,40,58091,68485,916278,914544,10470,15.5,8775,13,172781,73247,99534,8,18.9,169313,61449,107864,6.7,18.5,3468,0.4,37,0,6210,6219,33190
1984,41,52482,61768,789259,765430,9596,15.9,7060,11.7,159449,56851,102598,7.4,20.8,111791,41020,70771,5.4,14.6,47658,6.2,29.2,0,4722,4733,22430
1984,42,178940,217598,3956388,3867472,25281,11.7,21212,9.8,661034,220049,440985,5.7,17.1,483202,175486,307716,4.5,12.5,177832,4.6,25,0,12917,12986,76271
1984,44,18812,20883,352725,342904,2511,12.2,1985,9.6,59576,19241,40335,5.6,17.4,39934,13680,26254,4,11.6,19642,5.8,23.2,0,1323,1327,6390
1984,45,47764,58091,978678,939565,8610,15.6,3834,7,179203,68034,111169,7.2,19.1,100977,33218,67759,3.5,10.7,78226,8.4,21.4,0,127,130,1221
1984,46,14276,16261,175151,170357,2157,13.4,1865,11.6,32071,11763,20308,6.9,18.8,22482,9635,12847,5.7,13.2,9589,5.6,26.4,0,1067,1069,4851
1984,47,71061,86278,1489669,1448024,13068,15.4,9755,11.5,280923,102570,178353,7.1,19.4,197632,72903,124729,5,13.6,83291,5.8,27.2,0,6436,6470,35131
1984,48,264132,331867,5388331,5266633,52188,16,42659,13,1167145,499978,667167,9.5,22.2,923749,340019,583730,6.5,17.5,243396,4.7,35,0,27900,28024,172149
1984,49,24402,29152,449105,433613,4423,15.5,3364,11.8,91879,33790,58089,7.8,21.2,60895,23538,37357,5.4,14,30984,7.2,28,0,2145,2146,12195
1984,50,12300,13680,172966,166945,2007,15,1327,9.9,30391,11373,19018,6.8,18.2,18348,7424,10924,4.4,11,12043,7.2,22,0,899,901,4290
1984,51,78723,98417,1703098,1654170,13549,13.7,13608,13.8,314304,110148,204156,6.7,19,216447,97629,118818,5.9,13.1,97857,5.9,26.2,0,7052,7075,41773
1984,53,80717,95533,1287928,1252889,15169,16.3,10501,11.3,263775,100305,163470,8,21.1,193697,67933,125764,5.4,15.5,70078,5.6,31,0,6911,6919,35792
1984,54,24683,29710,424366,422005,3698,12.2,4520,14.9,69554,25610,43944,6.1,16.5,64831,30115,34716,7.1,15.4,4723,1.1,30.8,0,2264,2269,11559
1984,55,82663,96931,1585932,1538756,11883,12.4,9210,9.6,272262,89318,182944,5.8,17.7,177909,64385,113524,4.2,11.6,94353,6.1,23.2,0,5804,5824,28489
1984,56,11517,13197,134553,134617,1921,14.6,1840,14,28127,13622,14505,10.1,20.9,28254,10546,17708,7.8,21,-127,-0.1,41.8,0,1145,1148,5522
1985,01,56904,69263,1132026,1113206,9620,14.1,7859,11.5,199468,71006,128462,6.4,17.9,161828,62454,99374,5.6,14.5,37640,3.4,29,0,5158,5188,32391
1985,02,10189,11923,153653,149452,2350,20.2,1803,15.5,40928,16780,24148,11.2,27.4,32525,14139,18386,9.5,21.8,8403,5.6,43.6,0,1175,1180,6156
1985,04,53291,64612,1047984,997245,11646,18.5,7977,12.7,261005,96757,164248,9.7,26.2,159529,69480,90049,7,16,101476,10.2,32,0,5215,5248,37122
1985,05,38828,44972,657530,650439,6148,13.8,5289,11.9,112734,41362,71372,6.4,17.3,98553,42064,56489,6.5,15.2,14181,2.1,30.4,0,3690,3725,21256
1985,06,463300,556699,9259467,9081292,83652,15.3,65019,11.9,1923796,709752,1214044,7.8,21.2,1567447,619411,948036,6.8,17.3,356349,3.9,34.6,0,39811,40076,282553
1985,08,67414,79441,1162178,1146241,13226,16.9,11071,14.1,236595,99309,137286,8.7,20.6,204722,85626,119096,7.5,17.9,31873,2.7,35.8,0,7465,7490,48116
1985,09,63242,72502,1386089,1361371,9007,12.6,6959,9.7,219854,65510,154344,4.8,16.1,170417,64802,105615,4.8,12.5,49437,3.6,25,0,4630,4643,29287
1985,10,11023,12733,245391,239484,1744,13.9,1279,10.2,42724,13291,29433,5.5,17.8,30911,11193,19718,4.7,12.9,11813,4.9,25.8,0,768,770,4629
1985,11,14275,16470,363140,355228,1961,12.1,1472,9.1,65915,23434,42481,6.6,18.6,50091,21232,28859,6,14.1,15824,4.5,28.2,0,423,434,6255
1985,12,215201,259414,3696895,3602407,44981,17.8,32388,12.8,817753,339836,477917,9.4,22.7,628777,253410,375367,7,17.5,188976,5.2,35,0,22027,22110,139888
1985,13,96305,118783,2098739,2029062,18304,15.8,12568,10.8,418998,150247,268751,7.4,20.6,279644,109472,170172,5.4,13.8,139354,6.8,27.6,0,7867,7916,48801
1985,15,18464,22379,321101,316038,2927,13.2,2324,10.5,55528,22258,33270,7,17.6,45401,17168,28233,5.4,14.4,10127,3.2,28.8,0,1464,1476,7705
1985,16,17732,20897,250451,251095,2778,13.4,2477,11.9,43784,16149,27635,6.4,17.4,45074,15343,29731,6.1,18,-1290,-0.6,34.8,0,1631,1640,9030
1985,17,184677,218917,4098248,4066985,26119,12,23133,10.6,656369,237784,418585,5.8,16.1,593842,221356,372486,5.4,14.6,62527,1.5,29.2,0,14716,14800,98206
1985,18,84537,103018,1818077,1798119,12823,12.6,10765,10.6,282841,108879,173962,6.1,15.7,242925,90397,152528,5,13.5,39916,2.2,27,0,6795,6827,43382
1985,19,53774,64326,850501,848464,6627,10.2,7423,11.5,122944,42561,80383,5,14.5,118870,48780,70090,5.7,14,4074,0.5,28,0,4928,4947,25370
1985,20,48789,57371,788961,791169,7935,14,6271,11.1,136191,55539,80652,7,17.2,140607,70358,70249,8.9,17.8,-4416,-0.6,34.4,0,4116,4134,25739
1985,21,54185,64346,1037546,1017819,8038,12.6,7040,11,169409,60758,108651,6,16.6,129955,53039,76916,5.2,12.8,39454,3.8,25.6,0,4787,4816,26351
1985,22,69542,83464,1246422,1245248,11200,13.5,10257,12.3,223608,89005,134603,7.1,18,221260,81884,139376,6.6,17.8,2348,0.2,35.6,0,6828,6865,41109
1985,23,21796,25031,347664,344999,3486,14.2,2480,10.1,57463,22041,35422,6.4,16.7,52134,22708,29426,6.6,15.1,5329,1.6,30.2,0,1569,1573,9282
1985,24,68487,82601,1483820,1432958,11566,14.5,6610,8.3,297492,108579,188913,7.6,20.8,195767,70737,125030,4.9,13.7,101725,7.1,27.4,0,2356,2387,22239
1985,25,108631,126964,2609408,2563071,15964,12.8,11616,9.3,440945,134401,306544,5.2,17.2,348271,129460,218811,5.1,13.6,92674,3.6,27.2,0,7531,7560,61149
1985,26,135239,163398,2917551,2853139,20943,13,16236,10.1,522668,205232,317436,7.2,18.3,393844,172498,221346,6,13.8,128824,4.5,27.6,0,10581,10639,64455
1985,27,75220,89172,1585931,1558560,11258,12.7,9535,10.8,276911,105570,171341,6.8,17.8,222168,96843,125325,6.2,14.3,54743,3.5,28.6,0,6197,6229,53948
1985,28,37585,44765,658514,652421,5853,13.2,5147,11.6,107854,40183,67671,6.2,16.5,95667,37079,58588,5.7,14.7,12187,1.8,29.4,0,3459,3476,18729
1985,29,86028,103004,1767006,1746317,13853,13.6,11055,10.9,291299,110782,180517,6.3,16.7,249921,109112,140809,6.2,14.3,41378,2.4,28.6,0,7284,7320,45636
1985,30,19069,21604,217567,218380,2930,13.6,2745,12.8,35383,13882,21501,6.4,16.2,37010,16080,20930,7.4,16.9,-1627,-0.7,32.4,0,1817,1820,8384
1985,31,32820,38078,510937,503877,4739,12.6,3896,10.3,84259,36522,47737,7.2,16.7,70138,31576,38562,6.3,13.9,14121,2.8,27.8,0,2600,2611,16595
1985,32,17603,20476,376584,369360,3347,16.5,2865,14.2,72887,28701,44186,7.8,19.7,58439,28174,30265,7.6,15.8,14448,3.9,31.6,0,1891,1896,13367
1985,33,21587,24277,411235,400410,3935,16.7,2410,10.3,79034,27986,51048,7,19.7,57384,23044,34340,5.8,14.3,21650,5.4,28.6,0,1596,1600,11110
1985,34,145125,165701,2906129,2849019,21816,13.4,16267,10,526126,171396,354730,6,18.5,411906,154831,257075,5.4,14.5,114220,4,29,0,10716,10757,67457
1985,35,24968,29077,380925,373694,4372,15.2,3717,12.9,79348,30388,48960,8.1,21.2,64886,29470,35416,7.9,17.4,14462,3.8,34.8,0,2390,2399,14315
1985,36,333438,378095,6408203,6318865,47735,12.8,39210,10.5,1042135,342997,699138,5.4,16.5,863460,333782,529678,5.3,13.7,178675,2.8,27.4,0,27169,27278,161653
1985,37,102134,124671,2246722,2208228,17424,14.3,12491,10.2,366869,132590,234279,6,16.6,289882,100906,188976,4.6,13.1,76987,3.5,26.2,0,7985,8014,46028
1985,38,14661,16858,190074,188080,2057,12.3,1784,10.7,29866,11633,18233,6.2,15.9,25878,9750,16128,5.2,13.8,3988,2.1,27.6,0,1146,1148,5569
1985,39,161193,201446,3684315,3617237,23196,11.6,20025,10,599232,176659,422573,4.9,16.6,465076,192293,272783,5.3,12.9,134156,3.7,25.8,0,12393,12496,85682
1985,40,58653,69184,955006,956124,9748,14.1,9449,13.7,160118,65611,94507,6.9,16.7,162353,62992,99361,6.6,17,-2235,-0.3,33.4,0,6612,6630,35246
1985,41,53735,62941,833904,822548,9128,14.6,8219,13.1,158178,60129,98049,7.3,19.2,135466,56705,78761,6.9,16.5,22712,2.7,33,0,5457,5498,30667
1985,42,182765,221542,4017251,3992309,26007,11.8,22225,10.1,615141,216878,398263,5.4,15.4,565256,230383,334873,5.8,14.2,49885,1.2,28.4,0,13621,13722,114415
1985,44,19383,21512,360255,356688,2688,12.7,2095,9.9,54689,17115,37574,4.8,15.3,47554,16810,30744,4.7,13.3,7135,2,26.6,0,1436,1437,10414
1985,45,50222,60919,1031868,1012828,8858,14.9,6269,10.5,182571,67964,114607,6.7,18,144490,52802,91688,5.2,14.3,38081,3.7,28.6,0,4133,4146,26753
1985,46,14861,16857,192732,189598,2183,13.1,1739,10.4,31858,14062,17796,7.4,16.8,25590,9331,16259,4.9,13.5,6268,3.3,27,0,1103,1109,5409
1985,47,73597,89144,1571221,1541644,12390,14.1,9892,11.3,267016,96778,170238,6.3,17.3,207861,81419,126442,5.3,13.5,59155,3.8,27,0,6499,6551,36716
1985,48,273940,343120,5568969,5484012,53231,15.8,41813,12.4,1140695,471006,669689,8.6,20.8,970782,372071,598711,6.8,17.7,169913,3.1,35.4,0,26856,27037,180343
1985,49,24879,29637,469269,459964,4424,15,3954,13.4,88170,32749,55421,7.1,19.2,69560,27928,41632,6.1,15.1,18610,4.1,30.2,0,2573,2584,16124
1985,50,13196,14589,189009,186234,2121,14.9,1463,10.3,30230,11173,19057,6,16.2,24679,10646,14033,5.7,13.3,5551,2.9,26.6,0,974,975,4559
1985,51,88347,108858,1849666,1795831,15583,15,6346,6.1,331909,129207,202702,7.2,18.5,224238,71671,152567,4,12.5,107671,6,25,0,297,341,7925
1985,53,82898,97878,1351481,1331499,14324,14.8,12187,12.6,257339,100367,156972,7.5,19.3,217374,84729,132645,6.4,16.3,39965,3,32.6,0,7833,7885,44795
1985,54,26913,31939,443952,439735,3885,12.6,2239,7.2,66131,29136,36995,6.6,15,57696,16883,40813,3.8,13.1,8435,1.9,26.2,0,132,139,1293
1985,55,84433,98765,1608931,1593803,11583,11.8,9533,9.7,235528,82109,153419,5.2,14.8,205272,82211,123061,5.2,12.9,30256,1.9,25.8,0,6416,6466,40560
1985,56,11610,13269,136181,136316,1863,14.1,1810,13.7,26137,10909,15228,8,19.2,26406,10681,15725,7.8,19.4,-269,-0.2,38.4,0,1172,1174,6200
1986,01,58637,71456,1184866,1157441,10412,14.8,7918,11.3,226425,86524,139901,7.5,19.6,171575,61159,110416,5.3,14.8,54850,4.8,29.6,0,5302,5326,33580
1986,02,10332,12056,147765,150114,2279,19,2059,17.2,34108,15613,18495,10.4,22.7,38805,14050,24755,9.4,25.9,-4697,-3.2,45.4,0,1314,1314,7233
1986,04,56018,67984,1102696,1074830,12286,18.5,8632,13,260887,115495,145392,10.7,24.3,205155,75347,129808,7,19.1,55732,5.2,38.2,0,5788,5795,41667
1986,05,39347,45527,687135,671833,6172,13.6,5405,11.9,130539,50602,79937,7.5,19.4,99936,37859,62077,5.6,14.9,30603,4.5,29.8,0,3776,3794,20445
1986,06,481361,578182,9605492,9425326,92023,16.2,68261,12,2021626,830797,1190829,8.8,21.4,1661295,610238,1051057,6.5,17.6,360331,3.8,35.2,0,42785,42884,298844
1986,08,68458,80975,1186282,1173451,13382,16.7,11491,14.3,252003,115574,136429,9.8,21.5,226342,93887,132455,8,19.3,25661,2.2,38.6,0,7643,7663,51905
1986,09,65664,75134,1424212,1404785,9977,13.5,7109,9.6,226981,91312,135669,6.5,16.2,188126,64088,124038,4.6,13.4,38855,2.8,26.8,0,4640,4646,34398
1986,10,11624,13418,270707,257420,2016,15.4,1288,9.9,63695,34404,29291,13.4,24.7,37120,12329,24791,4.8,14.4,26575,10.3,28.8,0,793,794,4447
1986,11,14629,16930,386550,381871,2148,12.9,1643,9.8,65900,27713,38187,7.3,17.3,56541,17574,38967,4.6,14.8,9359,2.5,29.6,0,980,983,7295
1986,12,225869,271892,3883313,3787502,47591,17.9,34112,12.8,865212,378888,486324,10,22.8,673590,259818,413772,6.9,17.8,191622,5,35.6,0,23278,23310,147051
1986,13,100749,124204,2207877,2152526,19719,16.2,13765,11.3,432294,170234,262060,7.9,20.1,321591,126102,195489,5.9,14.9,110703,5.2,29.8,0,8758,8764,56258
1986,15,18958,23003,341572,331213,3021,13.3,2311,10.2,66632,26290,40342,7.9,20.1,45914,16007,29907,4.8,13.9,20718,6.2,27.8,0,1500,1500,7798
1986,16,18051,21219,255524,252742,2856,13.6,2418,11.5,45533,17495,28038,6.9,18,39969,13408,26561,5.3,15.8,5564,2.2,31.6,0,1555,1560,8338
1986,17,188829,223773,4212044,4152086,27683,12.5,22205,10,700842,271223,429619,6.5,16.9,580926,211964,368962,5.1,14,119916,2.9,28,0,14131,14169,98903
1986,18,86853,105751,1876142,1844133,13502,12.9,10408,10,305370,122581,182789,6.6,16.6,241352,85854,155498,4.7,13.1,64018,3.5,26.2,0,6855,6886,45431
1986,19,53517,63999,865742,857244,6866,10.7,6962,10.9,138520,56260,82260,6.6,16.2,121524,44855,76669,5.2,14.2,16996,2,28.4,0,4626,4626,24197
1986,20,48881,57567,804575,796104,7318,12.7,6866,12,140476,59344,81132,7.5,17.6,123533,48099,75434,6,15.5,16943,2.1,31,0,4727,4753,24706
1986,21,55355,65776,1079263,1057476,8494,13.1,6839,10.5,180811,71683,109128,6.8,17.1,137237,49447,87790,4.7,13,43574,4.1,26,0,4717,4731,27903
1986,22,69072,83237,1222012,1233080,11060,13.3,10891,13.1,221805,96930,124875,7.9,18,243940,83610,160330,6.8,19.8,-22135,-1.8,36,0,7528,7542,45764
1986,23,23017,26308,364589,356264,4015,15.6,2640,10.3,65102,25179,39923,7.1,18.3,48452,19178,29274,5.4,13.6,16650,4.7,27.2,0,1709,1726,9632
1986,24,72479,87147,1565605,1523191,13117,15.5,8401,9.9,316712,127820,188892,8.4,20.8,231883,83779,148104,5.5,15.2,84829,5.6,30.4,0,5197,5320,38822
1986,25,112759,131643,2678216,2641146,17767,13.7,12637,9.8,475846,181683,294163,6.9,18,401705,142391,259314,5.4,15.2,74141,2.8,30.4,0,8085,8108,67383
1986,26,138451,167450,3089824,3003004,21763,13.2,17202,10.4,550601,203717,346884,6.8,18.3,376960,140287,236673,4.7,12.6,173641,5.7,25.2,0,11282,11304,71744
1986,27,76442,90673,1621369,1602486,11606,12.9,9804,10.9,283872,103362,180510,6.5,17.7,246106,91613,154493,5.7,15.4,37766,2.3,30.8,0,6194,6221,47610
1986,28,38325,45637,687107,672467,6083,13.5,4997,11.1,129341,46289,83052,6.9,19.2,100060,36656,63404,5.5,14.9,29281,4.3,29.8,0,3274,3287,19813
1986,29,89489,107047,1835956,1800448,14609,13.9,10330,9.8,328724,131510,197214,7.3,18.3,257707,93536,164171,5.2,14.3,71017,4,28.6,0,6064,6104,42371
1986,30,19052,21621,215318,216491,2969,13.7,2817,13,35735,15503,20232,7.2,16.5,38082,14722,23360,6.8,17.6,-2347,-1.1,33,0,1920,1922,9412
1986,31,32836,38099,518158,514435,4143,10.9,3982,10.5,81361,35585,45776,6.9,15.8,73914,25002,48912,4.9,14.4,7447,1.4,28.8,0,2578,2585,13579
1986,32,18216,21170,394815,385468,3665,17.6,2889,13.9,81544,34843,46701,9,21.2,62850,28565,34285,7.4,16.3,18694,4.9,32.6,0,1917,1918,14199
1986,33,23372,26275,433332,422210,4736,18.7,2648,10.5,87898,37930,49968,9,20.8,65655,28202,37453,6.7,15.6,22243,5.2,31.2,0,1790,1792,12060
1986,34,150356,171239,2986344,2944309,23678,14.1,17618,10.5,553687,214193,339494,7.3,18.8,469617,160379,309238,5.4,15.9,84070,2.9,31.8,0,11489,11516,70144
1986,35,25598,29909,386766,383272,4741,16.1,3714,12.6,77063,35717,41346,9.3,20.1,70075,23117,46958,6,18.3,6988,1.8,36.6,0,2403,2406,13860
1986,36,340644,385808,6593924,6499881,50293,13.2,41451,10.9,1130049,415196,714853,6.4,17.4,941962,342601,599361,5.3,14.5,188087,2.9,29,0,28325,28407,162731
1986,37,106573,129909,2357008,2300094,18767,14.7,12976,10.2,419006,170998,248008,7.4,18.2,305179,108580,196599,4.7,13.3,113827,4.9,26.6,0,8481,8573,53039
1986,38,14663,16882,189037,189562,1876,11.1,1772,10.5,28001,11605,16396,6.1,14.8,29050,9665,19385,5.1,15.3,-1049,-0.5,29.6,0,1166,1169,5941
1986,39,164812,205807,3775369,3727732,24868,12.2,19914,9.8,614658,230213,384445,6.2,16.5,519384,192791,326593,5.2,13.9,95274,2.6,27.8,0,12613,12651,108633
1986,40,57575,68284,935921,944842,9345,13.6,9841,14.3,162525,73128,89397,7.7,17.2,180366,68345,112021,7.2,19.1,-17841,-1.9,34.4,0,6903,6921,37329
1986,41,55462,64798,856826,844527,9833,15.4,7798,12.2,159854,66569,93285,7.9,18.9,135256,53650,81606,6.4,16,24598,2.9,32,0,5225,5230,30161
1986,42,189315,228738,4138929,4076649,29142,12.9,21221,9.4,689332,276212,413120,6.8,16.9,564774,196904,367870,4.8,13.9,124558,3,27.8,0,13423,13456,99275
1986,44,20131,22348,379720,369651,3067,14,2141,9.8,64765,24409,40356,6.6,17.5,44627,17355,27272,4.7,12.1,20138,5.4,24.2,0,1435,1439,10578
1986,45,52164,63180,1058504,1044552,9136,14.7,6574,10.6,189501,75649,113852,7.2,18.1,161597,59137,102460,5.7,15.5,27904,2.6,31,0,4250,4253,26641
1986,46,14950,16954,193225,193007,1937,11.5,1766,10.5,29822,12482,17340,6.5,15.5,29385,10640,18745,5.5,15.2,437,0.3,30.4,0,1115,1116,6723
1986,47,75788,91817,1637750,1603062,13070,14.4,10013,11.1,299110,115740,183370,7.2,18.7,229734,87650,142084,5.5,14.3,69376,4.4,28.6,0,6690,6703,47135
1986,48,277741,348259,5562543,5561133,52914,15.3,46156,13.4,1091580,472714,618866,8.5,19.6,1088759,400440,688319,7.2,19.6,2821,0,39.2,0,31056,31199,211728
1986,49,25259,30150,487796,481290,4564,15.3,3935,13.2,98085,43612,54473,9.1,20.4,85074,31290,53784,6.5,17.7,13011,2.7,35.4,0,2551,2560,17844
1986,50,13768,15239,200092,194338,2338,15.7,1623,10.9,35385,13940,21445,7.2,18.2,23877,9353,14524,4.8,12.3,11508,5.9,24.6,0,1120,1120,5725
1986,51,93021,114574,1986268,1916697,17105,15.3,11114,10,387429,158225,229204,8.3,20.2,248286,89441,158845,4.7,13,139143,7.2,26,0,7062,7077,42478
1986,53,85622,100918,1410497,1380402,15705,15.8,12161,12.2,290360,111590,178770,8.1,21,230169,89738,140431,6.5,16.7,60191,4.3,33.4,0,7811,7853,47218
1986,54,27209,32207,448122,446056,3996,12.5,3654,11.4,79140,37048,42092,8.3,17.7,75008,33296,41712,7.5,16.8,4132,0.9,33.6,0,2302,2308,12429
1986,55,80616,95092,1602741,1599541,10425,10.8,12873,13.3,244522,91476,153046,5.7,15.3,238122,109118,129004,6.8,14.9,6400,0.4,29.8,0,6914,6949,42178
1986,56,11366,13021,132165,133664,1668,12.7,1844,14,24933,10978,13955,8.2,18.7,27931,10454,17477,7.8,20.9,-2998,-2.2,37.4,0,1239,1240,6534
1987,01,60258,73813,1207846,1200238,11313,15.6,8636,11.9,216610,85721,130889,7.1,18,201393,72345,129048,6,16.8,15217,1.2,33.6,0,5560,5603,33710
1987,02,9909,11684,139946,145006,2014,16.9,2281,19.2,29012,12933,16079,8.9,20,39131,16103,23028,11.1,27,-10119,-7,40,0,1453,1467,9133
1987,04,58318,71502,1133571,1123696,13545,19.4,9662,13.8,245284,115527,129757,10.3,21.8,225535,97931,127604,8.7,20.1,19749,1.7,40.2,0,6185,6243,45399
1987,05,39898,46468,702722,699345,6842,14.9,5660,12.3,120338,46580,73758,6.7,17.2,113583,46595,66988,6.7,16.2,6755,1,32.4,0,3946,3977,26184
1987,06,498637,601790,10025084,9883744,101130,17.1,74324,12.6,2140335,845682,1294653,8.6,21.7,1857655,787625,1070030,8,18.8,282680,2.9,37.6,0,47020,47572,364454
1987,08,68775,81912,1157146,1179240,13875,17,12495,15.3,229481,110481,119000,9.4,19.5,273670,119082,154588,10.1,23.2,-44189,-3.7,39,0,7987,8086,57649
1987,09,68351,78649,1489534,1459992,11757,15.3,7985,10.4,253323,92247,161076,6.3,17.4,194239,73950,120289,5.1,13.3,59084,4.1,26.6,0,5283,5306,36699
1987,10,12152,14145,270780,272279,2247,16.3,1478,10.7,52242,16706,35536,6.1,19.2,55240,14583,40657,5.4,20.3,-2998,-1.1,38.4,0,928,930,5413
1987,11,14828,17220,408195,399585,2205,12.9,1898,11.1,69721,24162,45559,6,17.4,52500,20405,32095,5.1,13.1,17221,4.3,26.2,0,1065,1075,8846
1987,12,235617,286073,4052723,3985126,53022,19,37431,13.4,896735,416100,480635,10.4,22.5,761541,320415,441126,8,19.1,135194,3.4,38.2,0,25796,25981,175329
1987,13,104235,129764,2298424,2265027,21394,16.8,15351,12.1,460060,202803,257257,9,20.3,393265,152591,240674,6.7,17.4,66795,2.9,34.8,0,9720,9794,67453
1987,15,19499,23814,361746,353282,3522,15,2593,11.1,76341,30077,46264,8.5,21.6,59414,24867,34547,7,16.8,16927,4.8,33.6,0,1621,1632,11021
1987,16,18375,21600,253867,254619,3168,14.8,2637,12.3,47568,20310,27258,8,18.7,49072,20011,29061,7.9,19.3,-1504,-0.6,37.4,0,1535,1548,10497
1987,17,192023,228983,4229458,4232605,30933,13.7,24886,11,687079,265263,421816,6.3,16.2,693372,274757,418615,6.5,16.4,-6293,-0.2,32.4,0,15370,15476,104806
1987,18,88834,108810,1960404,1923141,14915,13.9,11508,10.7,353945,127028,226917,6.6,18.4,279421,110968,168453,5.8,14.5,74524,3.9,29,0,7325,7375,50562
1987,19,53491,64363,885967,879780,7803,12.1,7176,11.2,144222,58643,85579,6.7,16.4,131849,51190,80659,5.8,15,12373,1.4,30,0,4486,4539,24971
1987,20,48907,57884,785708,798343,7698,13.3,7132,12.3,135791,59363,76428,7.4,17,161060,83039,78021,10.4,20.2,-25269,-3.2,34,0,4639,4691,27901
1987,21,56376,67318,1113359,1101927,9376,14.1,7611,11.4,186004,71549,114455,6.5,16.9,163140,67496,95644,6.1,14.8,22864,2.1,29.6,0,4840,4853,30040
1987,22,66411,80651,1160169,1193986,10617,12.9,12637,15.4,204782,90650,114132,7.6,17.2,272417,108828,163589,9.1,22.8,-67635,-5.6,34.4,0,8110,8193,52757
1987,23,24466,28132,392237,380019,4820,17.7,2921,10.7,75649,31734,43915,8.4,19.9,51212,22532,28680,5.9,13.5,24437,6.4,27,0,1912,1918,10720
1987,24,75607,91745,1671105,1624802,14470,16.2,9703,10.8,349051,159196,189855,9.8,21.5,256444,94454,161990,5.8,15.8,92607,5.7,31.6,0,6105,6170,44401
1987,25,116844,137046,2734149,2715234,19834,14.8,13913,10.3,473975,176577,297398,6.5,17.5,436145,161309,274836,5.9,16.1,37830,1.4,32.2,0,9122,9171,71481
1987,26,142587,173534,3176885,3147301,24903,14.6,18161,10.6,535609,204900,330709,6.5,17,476441,171999,304442,5.5,15.1,59168,1.9,30.2,0,11694,11791,76827
1987,27,77712,92833,1666676,1652382,12695,13.8,10134,11,288829,110229,178600,6.7,17.5,260242,113151,147091,6.8,15.7,28587,1.8,31.4,0,6287,6335,62679
1987,28,38752,46339,690876,692385,6560,14.3,5563,12.1,117326,47639,69687,6.9,16.9,120344,42987,77357,6.2,17.4,-3018,-0.5,33.8,0,3713,3746,23234
1987,29,91762,110633,1892023,1870316,16482,15.1,12576,11.5,344344,137609,206735,7.4,18.4,300929,119876,181053,6.4,16.1,43415,2.3,32.2,0,8070,8145,54232
1987,30,19005,21722,218888,217775,3186,14.7,2933,13.5,41249,17277,23972,7.9,18.9,39022,15777,23245,7.2,17.9,2227,1,35.8,0,1877,1893,8804
1987,31,33068,38628,531774,527217,4629,12.1,3928,10.2,87217,32348,54869,6.1,16.5,78102,33124,44978,6.3,14.8,9115,1.7,29.6,0,2524,2552,14757
1987,32,19135,22309,433896,415841,4226,19.4,2976,13.7,102517,41927,60590,10.1,24.7,66407,26805,39602,6.4,16,36110,8.7,32,0,1873,1893,14675
1987,33,25249,28557,453350,444310,5401,19.7,3030,11,89012,36549,52463,8.2,20,70933,27611,43322,6.2,16,18079,4,32,0,2032,2037,14418
1987,34,155668,178070,3105044,3053041,26411,15.1,18969,10.9,621146,253114,368032,8.3,20.3,517140,198113,319027,6.5,16.9,104006,3.4,33.8,0,12492,12555,86591
1987,35,25937,30459,395479,393305,4754,15.7,3987,13.2,80836,36907,43929,9.4,20.6,76488,29618,46870,7.5,19.4,4348,1.2,38.8,0,2608,2622,16473
1987,36,346612,394396,6816421,6760940,54495,14,44355,11.4,1147940,396993,750947,5.9,17,1036978,382309,654669,5.7,15.3,110962,1.7,30.6,0,30975,31100,201760
1987,37,109913,135644,2406240,2388193,20694,15.6,14436,10.9,418604,161377,257227,6.8,17.5,382509,140901,241608,5.9,16,36095,1.5,32,0,9271,9304,61799
1987,38,14755,17058,191873,190797,2119,12.5,1871,11,30371,12851,17520,6.7,15.9,28218,10838,17380,5.7,14.8,2153,1.1,29.6,0,1195,1204,6034
1987,39,168401,211958,3871737,3834228,28393,13.6,21448,10.3,664785,253154,411631,6.6,17.3,589767,239028,350739,6.2,15.4,75018,1.9,30.8,0,13069,13196,94165
1987,40,55905,66914,904708,925714,9301,13.7,10158,15,153934,72602,81332,7.8,16.6,195946,78028,117918,8.4,21.2,-42012,-4.6,33.2,0,6722,6799,40496
1987,41,56822,66905,892491,876897,10977,16.7,8551,13,175460,72283,103177,8.2,20,144272,62050,82222,7.1,16.5,31188,3.5,33,0,5621,5650,34866
1987,42,194697,236702,4254617,4211900,31900,13.7,23240,10,710491,268721,441770,6.4,16.9,625058,243157,381901,5.8,14.8,85433,2.1,29.6,0,14650,14768,107955
1987,44,20985,23374,396097,388723,3504,15.3,2390,10.5,67634,24483,43151,6.3,17.4,52886,20445,32441,5.3,13.6,14748,3.8,27.2,0,1637,1650,10956
1987,45,53782,65831,1112311,1089692,10323,16,7369,11.4,211303,83460,127843,7.7,19.4,166066,64762,101304,5.9,15.2,45237,4.2,30.4,0,4649,4688,30471
1987,46,15111,17196,200245,198232,2220,13,1938,11.3,32038,13100,18938,6.6,16.2,28011,11308,16703,5.7,14.1,4027,2.1,28.2,0,1202,1209,6409
1987,47,78066,95419,1693431,1672313,14691,15.7,10644,11.4,309573,118339,191234,7.1,18.5,267336,110977,156359,6.6,16,42237,2.5,32,0,7096,7129,49284
1987,48,273401,346457,5363099,5478753,53577,15.4,53079,15.3,1013846,466491,547355,8.5,18.5,1245154,503652,741502,9.2,22.7,-231308,-4.2,37,0,34454,34860,237080
1987,49,25704,30862,499870,496982,5009,16.4,4136,13.5,97231,38705,58526,7.8,19.6,91456,37675,53781,7.6,18.4,5775,1.2,36.8,0,2522,2566,17771
1987,50,14606,16245,214281,207870,2656,16.9,1583,10.1,40063,17618,22445,8.5,19.3,27241,11434,15807,5.5,13.1,12822,6.2,26.2,0,1121,1134,6760
1987,51,96918,120928,2083670,2036958,19610,16.6,12893,10.9,411682,173310,238372,8.5,20.2,318257,127025,191232,6.2,15.6,93425,4.6,31.2,0,8210,8285,53752
1987,53,88044,104592,1456135,1423705,17335,16.9,13066,12.7,305161,125179,179982,8.8,21.4,240300,98808,141492,6.9,16.9,64861,4.5,33.8,0,8351,8438,53066
1987,54,27543,32931,453892,452255,4621,14.2,3678,11.3,75354,32401,42953,7.2,16.7,72080,28164,43916,6.2,15.9,3274,0.8,31.8,0,2402,2415,14349
1987,55,86963,103021,1719999,1672542,14396,14.5,7186,7.3,285970,120228,165742,7.2,17.1,191056,60276,130780,3.6,11.4,94914,5.7,22.8,0,1857,1920,17586
1987,56,11030,12660,121691,127412,1673,13,1930,15,19490,8937,10553,7,15.3,30931,12294,18637,9.6,24.3,-11441,-9,30.6,0,1188,1196,6212
1988,01,60133,74074,1224901,1208299,9836,13.3,8891,12.1,222085,93070,129015,7.7,18.4,188880,73633,115247,6.1,15.6,33205,2.8,31.2,0,5836,5836,33259
1988,02,9722,11502,131553,133238,1814,15.7,1861,16.1,30190,12815,17375,9.6,22.7,33559,15402,18157,11.6,25.2,-3369,-2.5,45.4,0,1148,1148,6412
1988,04,58831,72792,1167257,1141813,11908,16.5,10152,14.1,264968,116438,148530,10.2,23.2,214081,87104,126977,7.6,18.7,50887,4.5,37.4,0,6765,6765,44302
1988,05,38802,45640,685784,676843,5764,12.6,5683,12.4,120746,46066,74680,6.8,17.8,102865,41046,61819,6.1,15.2,17881,2.6,30.4,0,3915,3915,19632
1988,06,505005,612513,10361697,10149718,89631,14.8,75767,12.5,2228133,822891,1405242,8.1,22,1804176,686503,1117673,6.8,17.8,423957,4.2,35.6,0,49544,49545,319211
1988,08,67973,81494,1161087,1156028,12191,14.9,12132,14.9,226436,92574,133862,8,19.6,216318,92882,123436,8,18.7,10118,0.9,37.4,0,8319,8319,45630
1988,09,70038,80886,1494340,1482419,11063,13.9,8430,10.6,262143,106749,155394,7.2,17.7,238300,95901,142399,6.5,16.1,23843,1.6,32.2,0,5704,5704,38946
1988,10,12312,14401,286287,278434,1965,13.8,1660,11.6,55331,20849,34482,7.5,19.9,39624,15907,23717,5.7,14.2,15707,5.7,28.4,0,982,982,6084
1988,11,14784,17420,412783,412673,2131,12.3,1887,10.9,70149,22092,48057,5.4,17,69931,20728,49203,5,16.9,218,0.1,33.8,0,1124,1124,10419
1988,12,240864,294111,4223310,4128970,48708,16.8,39613,13.7,918689,388618,530071,9.4,22.2,730009,305940,424069,7.4,17.7,188680,4.5,35.4,0,28179,28181,165880
1988,13,105905,132685,2390742,2334375,19487,14.9,15821,12.1,490493,203681,286812,8.7,21,377758,147951,229807,6.3,16.2,112735,4.8,32.4,0,10461,10464,65213
1988,15,19794,24301,381903,372821,3087,12.8,2558,10.6,71128,25953,45175,7,19.1,52963,20664,32299,5.5,14.2,18165,4.9,28.4,0,1688,1688,8967
1988,16,18123,21455,260001,254539,2746,12.8,2564,12,51937,21446,30491,8.4,20.4,41014,16852,24162,6.6,16.1,10923,4.3,32.2,0,1725,1725,9259
1988,17,192616,231231,4335232,4241579,28147,12.3,23732,10.3,767656,280592,487064,6.6,18.1,580351,218314,362037,5.1,13.7,187305,4.4,27.4,0,15499,15499,95916
1988,18,89111,109639,1979163,1950551,12975,11.9,11344,10.4,334352,122440,211912,6.3,17.1,277127,114288,162839,5.9,14.2,57225,2.9,28.4,0,7420,7420,62030
1988,19,52712,63826,919659,893896,6597,10.3,6565,10.3,158739,52194,106545,5.8,17.8,107213,44142,63071,4.9,12,51526,5.8,24,0,4300,4301,20523
1988,20,48576,58039,798410,787135,6994,12.1,6377,11,140038,58012,82026,7.4,17.8,117487,46324,71163,5.9,14.9,22551,2.9,29.8,0,4328,4328,24363
1988,21,56081,67582,1093545,1070294,8637,12.9,7582,11.3,198624,77680,120944,7.3,18.6,152122,59990,92132,5.6,14.2,46502,4.4,28.4,0,5323,5323,30685
1988,22,64474,79045,1169018,1157912,9615,12.1,10602,13.3,221085,84223,136862,7.3,19.1,198874,81808,117066,7.1,17.2,22211,1.9,34.4,0,7153,7153,40798
1988,23,25145,28904,413036,399702,4249,14.9,3185,11.2,79769,26867,52902,6.7,20,53101,19332,33769,4.8,13.3,26668,6.7,26.6,0,2191,2191,10580
1988,24,77607,94737,1728638,1697971,13530,14.5,10254,11,346283,135241,211042,8,20.4,284949,97172,187777,5.7,16.8,61334,3.6,33.6,0,6595,6595,47169
1988,25,119327,140083,2810864,2774318,17905,12.9,14404,10.4,496769,177471,319298,6.4,17.9,423677,152920,270757,5.5,15.3,73092,2.6,30.6,0,9538,9538,73354
1988,26,143989,175707,3209475,3185315,21535,12.3,18880,10.8,537229,208433,328796,6.5,16.9,488908,171871,317037,5.4,15.3,48321,1.6,30.6,0,12055,12055,70380
1988,27,77716,93508,1710701,1678821,11332,12.2,10005,10.8,308403,105018,203385,6.3,18.4,244643,92615,152028,5.5,14.6,63760,3.8,29.2,0,6375,6375,43109
1988,28,38013,45843,681556,670222,5580,12.1,5642,12.3,118833,47411,71422,7.1,17.7,96164,37431,58733,5.6,14.3,22669,3.4,28.6,0,3896,3897,19049
1988,29,91198,110815,1861725,1854926,14218,12.9,12813,11.6,324881,124591,200290,6.7,17.5,311284,136131,175153,7.3,16.8,13597,0.7,33.6,0,8419,8419,46165
1988,30,18279,21065,197146,198085,2677,12.6,2868,13.5,36267,14647,21620,7.4,18.3,38144,16564,21580,8.4,19.3,-1877,-1,36.6,0,1863,1863,8789
1988,31,32283,38082,535125,522236,4190,11,3867,10.2,95827,35151,60676,6.7,18.3,70048,28936,41112,5.5,13.4,25779,4.9,26.8,0,2535,2535,12417
1988,32,19608,23086,458993,445287,3865,17,3002,13.2,109348,41415,67933,9.3,24.6,81935,35641,46294,8,18.4,27413,6.2,36.8,0,2012,2012,14137
1988,33,25833,29339,449937,439825,4657,16.2,3531,12.2,89741,37679,52062,8.6,20.4,69516,25338,44178,5.8,15.8,20225,4.6,31.6,0,2503,2503,13495
1988,34,158581,182189,3155330,3112640,24536,13.6,19500,10.8,589124,215975,373149,6.9,18.9,503743,166432,337311,5.3,16.2,85381,2.7,32.4,0,13325,13325,70783
1988,35,25540,30306,385769,382932,4192,13.8,4075,13.4,76090,29824,46266,7.8,19.9,70415,28320,42095,7.4,18.4,5675,1.5,36.8,0,2750,2750,15907
1988,36,348575,398492,6864229,6811429,50752,12.8,45035,11.4,1198599,400716,797883,5.9,17.6,1092999,368502,724497,5.4,16,105600,1.6,32,0,31748,31749,171335
1988,37,111672,138754,2504775,2443107,18924,13.8,15115,11,453264,177742,275522,7.3,18.6,329928,123738,206190,5.1,13.5,123336,5.1,27,0,9816,9816,50902
1988,38,14344,16650,183379,180615,1784,10.7,1802,10.8,30495,11435,19060,6.3,16.9,24967,10415,14552,5.8,13.8,5528,3.1,27.6,0,1141,1141,5221
1988,39,170138,214686,4009761,3939083,25144,11.8,22123,10.4,689162,258245,430917,6.6,17.5,547807,194273,353534,4.9,13.9,141355,3.6,27.8,0,13474,13475,76221
1988,40,53602,64831,875988,867352,8135,12.4,9274,14.1,166728,65195,101533,7.5,19.2,149455,63765,85690,7.4,17.2,17273,2,34.4,0,6193,6193,31929
1988,41,56728,67301,910474,887575,9538,14.3,8447,12.6,185573,68200,117373,7.7,20.9,139777,58644,81133,6.6,15.7,45796,5.2,31.4,0,5723,5723,29244
1988,42,197264,240412,4356960,4298059,28607,12,23971,10.1,730705,262643,468062,6.1,17,612904,232102,380802,5.4,14.3,117801,2.7,28.6,0,15464,15467,106051
1988,44,21357,23771,401326,397924,3173,13.5,2663,11.3,68196,23170,45026,5.8,17.1,61393,23556,37837,5.9,15.4,6803,1.7,30.8,0,1766,1766,9857
1988,45,54527,67141,1157753,1121053,9438,14.2,7770,11.7,229049,102549,126500,9.1,20.4,155650,61085,94565,5.4,13.9,73399,6.5,27.8,0,5129,5129,27206
1988,46,14953,17063,194242,190724,1976,11.6,1862,10.9,32718,12910,19808,6.8,17.2,25681,10800,14881,5.7,13.5,7037,3.7,27,0,1202,1202,5517
1988,47,78439,96811,1742005,1702024,13377,14,11071,11.5,346069,152148,193921,8.9,20.3,266106,107517,158589,6.3,15.6,79963,4.7,31.2,0,7400,7400,43981
1988,48,266880,341407,5405096,5365881,47230,13.7,50099,14.6,1103222,457121,646101,8.5,20.6,1024793,425297,599496,7.9,19.1,78429,1.5,38.2,0,33950,33950,198917
1988,49,25513,30856,499578,492490,4516,14.6,4247,13.8,100639,42591,58048,8.6,20.4,86462,36742,49720,7.5,17.6,14177,2.8,35.2,0,2835,2835,18732
1988,50,14785,16484,205845,204173,2368,14.6,1817,11.2,35635,14333,21302,7,17.5,32290,12776,19514,6.3,15.8,3345,1.7,31.6,0,1281,1281,6930
1988,51,99471,124670,2159296,2105658,17904,14.6,13531,11,419193,169562,249631,8.1,19.9,311919,119238,192681,5.7,14.8,107274,5.1,29.6,0,8730,8730,47580
1988,53,88773,105987,1500913,1461310,15493,14.7,13088,12.5,323294,113996,209298,7.8,22.1,244087,97694,146393,6.7,16.7,79207,5.4,33.4,0,8497,8499,46219
1988,54,27511,32973,452374,447788,3924,12,3615,11,77335,30540,46795,6.8,17.3,68163,25633,42530,5.7,15.2,9172,2.1,30.4,0,2395,2395,12605
1988,55,87621,104247,1796220,1755600,11564,11.2,9948,9.6,294577,104054,190523,5.9,16.8,213337,75847,137490,4.3,12.2,81240,4.6,24.4,0,6663,6663,38149
1988,56,10765,12384,119460,119605,1480,11.8,1645,13.2,22038,8670,13368,7.2,18.4,22328,9280,13048,7.8,18.7,-290,-0.3,36.8,0,1060,1060,4752
1989,01,61306,76014,1289214,1259370,10009,13.3,8158,10.9,233009,91168,141841,7.2,18.5,173321,61080,112241,4.9,13.8,59688,4.7,27.6,0,5660,5685,34928
1989,02,8518,10384,137275,134618,1495,13.7,2619,23.9,35909,16160,19749,12,26.7,30595,17746,12849,13.2,22.7,5314,4,45.4,0,884,887,4217
1989,04,59371,73858,1206137,1187751,11479,15.7,10299,14,256405,108617,147788,9.1,21.6,219635,89535,130100,7.5,18.5,36770,3.1,37,0,6826,6862,52184
1989,05,39202,46467,718533,702968,5746,12.5,5050,11,128382,53331,75051,7.6,18.3,97253,39392,57861,5.6,13.8,31129,4.5,27.6,0,3561,3622,25409
1989,06,497327,610180,10673073,10516224,87685,14.3,90078,14.7,2214576,823088,1391488,7.8,21.1,1900878,806222,1094656,7.7,18.1,313698,3,36.2,0,48921,49255,371482.5
1989,08,67995,81688,1201128,1182445,11280,13.8,11054,13.6,235672,94535,141137,8,19.9,198306,87671,110635,7.4,16.8,37366,3.1,33.6,0,7366,7398,48658
1989,09,70819,82079,1511870,1500115,10080,12.4,8952,11,247002,89312,157690,6,16.5,223491,79016,144475,5.3,14.9,23511,1.6,29.8,0,6102,6146,39044
1989,10,12979,15238,304516,295576,2278,15.4,1468,9.9,58076,25642,32434,8.7,19.6,40196,10963,29233,3.7,13.6,17880,6,27.2,0,935,939,6322
1989,11,14740,17671,410406,405978,2055,11.7,1844,10.5,68415,21286,47129,5.2,16.9,59560,21575,37985,5.3,14.7,8855,2.2,29.4,0,1097,1099,10076
1989,12,246158,301917,4441184,4340752,46039,15.5,38421,12.9,937193,381828,555365,8.8,21.6,736328,292733,443595,6.7,17,200865,4.6,34,0,26774,26943,173642
1989,13,107578,135772,2465041,2432773,18807,14,15789,11.8,491634,204011,287623,8.4,20.2,427097,148101,278996,6.1,17.6,64537,2.6,35.2,0,10394,10446,77005.5
1989,15,20055,24868,404100,393082,2970,12.1,2428,9.9,72568,28842,43726,7.3,18.5,50531,19410,31121,4.9,12.9,22037,5.6,25.8,0,1614,1614,10181
1989,16,18394,21842,282911,271892,2836,13.1,2469,11.4,59044,23715,35329,8.7,21.7,37006,15661,21345,5.8,13.6,22038,8.1,27.2,0,1574,1596,9385
1989,17,195191,235604,4487305,4413452,27828,11.9,23572,10.1,753373,291149,462224,6.6,17.1,605668,209215,396453,4.7,13.7,147705,3.4,27.4,0,15220,15424,109927
1989,18,90618,112236,2086211,2037085,13116,11.8,10645,9.6,347524,123044,224480,6,17.1,249271,93597,155674,4.6,12.2,98253,4.9,24.4,0,7194,7242,53326
1989,19,53217,64661,976507,947453,6643,10.3,5850,9.1,167430,67668,99762,7.1,17.7,109321,42751,66570,4.5,11.5,58109,6.2,23,0,3994,3999,22412
1989,20,48577,58350,850959,824926,6609,11.4,6329,10.9,166152,80481,85671,9.8,20.1,114086,44156,69930,5.4,13.8,52066,6.3,27.6,0,4383,4407,26349
1989,21,56900,68895,1138414,1115697,8303,12.2,7008,10.3,196726,74254,122472,6.7,17.6,151293,58276,93017,5.2,13.6,45433,4,27.2,0,4895,4920,31698
1989,22,63629,78520,1203112,1186687,8641,11,9323,11.8,223892,82528,141364,7,18.9,191041,74312,116729,6.3,16.1,32851,2.8,32.2,0,6186,6229,42411
1989,23,25805,29875,427188,420289,4177,14.2,3279,11.2,77042,28191,48851,6.7,18.3,63243,23589,39654,5.6,15,13799,3.3,30,0,2274,2308,14345
1989,24,79783,97856,1768104,1749401,13061,13.6,9983,10.4,317265,124332,192933,7.1,18.1,279858,93126,186732,5.3,16,37407,2.1,32,0,6471,6498,46466
1989,25,120312,142397,2858739,2836688,16701,11.8,14844,10.5,480197,169011,311186,6,16.9,436094,140849,295245,5,15.4,44103,1.5,30.8,0,10198,10370,76971
1989,26,146920,180311,3332727,3272939,21646,12.2,17318,9.7,555266,191563,363703,5.9,17,435690,144469,291221,4.4,13.3,119576,3.7,26.6,0,11608,11675,80288.5
1989,27,79180,95704,1770417,1740605,11414,12.1,9196,9.7,292296,108311,183985,6.2,16.8,232671,92919,139752,5.3,13.4,59625,3.4,26.8,0,5974,6011,43493
1989,28,38176,46432,704912,695980,5583,12.1,5062,11,118065,45903,72162,6.6,17,100201,39840,60361,5.7,14.4,17864,2.6,28.8,0,3514,3546,22423
1989,29,92882,113353,1937189,1900552,14291,12.8,11751,10.5,340486,120108,220378,6.3,17.9,267212,95615,171597,5,14.1,73274,3.8,28.2,0,7935,7996,53542
1989,30,18447,21256,207443,202220,2701,12.8,2460,11.6,39870,16129,23741,8,19.7,29424,11903,17521,5.9,14.6,10446,5.1,29.2,0,1639,1641,7672
1989,31,32512,38574,558295,546735,4293,11.2,3776,9.9,93401,34249,59152,6.3,17.1,70281,27488,42793,5,12.9,23120,4.2,25.8,0,2525,2535,15480
1989,32,20656,24365,496612,478236,4142,17.5,2856,12,116364,40897,75467,8.6,24.3,79614,33534,46080,7,16.6,36750,7.7,33.2,0,1860,1868,17097
1989,33,25964,29721,459472,455591,4078,13.8,3707,12.6,79345,34409,44936,7.6,17.4,71582,26212,45370,5.8,15.7,7763,1.7,31.4,0,2715,2741,17045
1989,34,159955,184810,3210283,3186478,22984,12.5,20522,11.2,571645,209294,362351,6.6,17.9,524034,170248,353786,5.3,16.4,47611,1.5,32.8,0,13692,13748,89068
1989,35,25766,30708,394118,389990,4225,13.9,3853,12.6,75446,30448,44998,7.8,19.3,67190,25475,41715,6.5,17.2,8256,2.1,34.4,0,2568,2586,15550
1989,36,351755,404333,6984799,6922355,50602,12.6,45366,11.3,1149527,411152,738375,5.9,16.6,1024639,351403,673236,5.1,14.8,124888,1.8,29.6,0,31578,31762,195782
1989,37,114402,142586,2593227,2557204,18299,13,14564,10.4,436657,169917,266740,6.6,17.1,364610,119777,244833,4.7,14.3,72047,2.8,28.6,0,9466,9524,58887
1989,38,14374,16777,187360,184980,1673,10,1554,9.3,28989,11733,17256,6.3,15.7,24228,9356,14872,5.1,13.1,4761,2.6,26.2,0,1069,1072,5263
1989,39,172489,219033,4166489,4096283,24718,11.4,20521,9.5,699613,266428,433185,6.5,17.1,559201,206482,352719,5,13.7,140412,3.4,27.4,0,13319,13439,92377
1989,40,53837,65207,904032,891090,8224,12.6,7926,12.2,164696,62305,102391,7,18.5,138811,58735,80076,6.6,15.6,25885,2.9,31.2,0,5432,5468,34900
1989,41,51213,62002,925928,919420,8202,12.7,13447,20.8,200594,67689,132905,7.4,21.8,187578,112226,75352,12.2,20.4,13016,1.4,40.8,0,5143,5178,31825
1989,42,201138,245949,4473116,4409414,28179,11.6,22807,9.4,713115,260079,453036,5.9,16.2,585711,213035,372676,4.8,13.3,127404,2.9,26.6,0,14985,15157,105869
1989,44,21791,24360,406004,404615,3142,13.1,2637,11,66698,28036,38662,6.9,16.5,63919,22655,41264,5.6,15.8,2779,0.7,31.6,0,1892,1919,14483.5
1989,45,55592,68817,1201694,1182060,8894,13.1,7258,10.7,209337,81280,128057,6.9,17.7,170068,67168,102900,5.7,14.4,39269,3.3,28.8,0,4855,4872,36460.5
1989,46,15131,17346,203018,198652,1898,11,1587,9.2,34079,11312,22767,5.7,17.2,25347,9745,15602,4.9,12.8,8732,4.4,25.6,0,1116,1116,5681
1989,47,79653,99307,1827088,1789321,12914,13.2,10607,10.8,337559,128938,208621,7.2,18.9,262025,97299,164726,5.4,14.6,75534,4.3,29.2,0,7197,7341,56822
1989,48,265421,340887,5596671,5508593,44527,13.1,45313,13.3,1139912,438091,701821,8,20.7,963756,408980,554776,7.4,17.5,176156,3.2,35,0,29642,30014,226497.5
1989,49,25495,31047,537212,520388,4173,13.5,3979,12.9,116631,46586,70045,9,22.4,82984,34177,48807,6.6,15.9,33647,6.5,31.8,0,2576,2658,19902
1989,50,15271,17094,217623,212300,2444,14.6,1861,11.1,36962,14816,22146,7,17.4,26316,10551,15765,5,12.4,10646,5,24.8,0,1365,1390,7117
1989,51,101909,128755,2257746,2211800,17512,13.8,13557,10.7,408841,165216,243625,7.5,18.5,316949,110277,206672,5,14.3,91892,4.2,28.6,0,8821,8901,56501
1989,53,75543,93124,1557782,1530599,12963,13,25690,25.8,385917,113917,272000,7.4,25.2,331551,202429,129122,13.2,21.7,54366,3.5,43.4,0,8112,8170,54996
1989,54,27714,33385,468222,461621,3795,11.4,3398,10.2,77410,33362,44048,7.2,16.8,64207,23423,40784,5.1,13.9,13203,2.9,27.8,0,2318,2330,13893
1989,55,88782,106209,1870622,1834614,11772,11.2,9823,9.3,296419,94640,201779,5.2,16.2,224404,82812,141592,4.5,12.2,72015,4,24.4,0,6536,6573,44682
1989,56,10698,12358,123620,121576,1423,11.5,1428,11.5,23102,8405,14697,6.9,19,19014,7196,11818,5.9,15.6,4088,3.4,31.2,0,932,937,4581
1990,01,62128,77158,1329740,1308045,9446,12.3,7845,10.2,217320,72790,144530,5.6,16.6,173930,59017,114913,4.5,13.3,43390,3.3,26.6,0,5512,5556,35188
1990,02,10157,12097,153834,143520,2828,25.2,1072,9.5,43163,22297,20866,15.5,30.1,22535,7288,15247,5.1,15.7,20628,14.4,31.4,0,648,649,4045
1990,04,60339,75080,1221750,1211932,11266,15.1,9402,12.6,237888,94689,143199,7.8,19.6,218252,79134,139118,6.5,18,19636,1.6,36,0,6365,6416,43173
1990,05,39886,47312,744176,730873,5776,12.3,4608,9.8,119170,41301,77869,5.7,16.3,92563,29107,63456,4,12.7,26607,3.6,25.4,0,3319,3321,17988
1990,06,526427,642827,11168083,10908220,104509,16.7,67345,10.8,2285878,920105,1365773,8.4,21,1766153,619747,1146406,5.7,16.2,519725,4.8,32.4,0,45313,45517,342700
1990,08,69416,83404,1239777,1220282,11760,14.2,9552,11.6,229059,93101,135958,7.6,18.8,190068,79909,110159,6.5,15.6,38991,3.2,31.2,0,6444,6478,45973
1990,09,70300,81871,1486355,1497164,9025,11,8638,10.5,202125,74476,127649,5,13.5,223745,69670,154075,4.7,14.9,-21620,-1.4,27,0,5973,6003,37713
1990,10,13461,15859,313490,308937,2148,13.8,1445,9.3,46540,14302,32238,4.6,15.1,37433,10085,27348,3.3,12.1,9107,3,24.2,0,958,958,5745
1990,11,14497,17468,406561,408738,1880,10.7,1970,11.2,56838,18056,38782,4.4,13.9,61191,17522,43669,4.3,15,-4353,-1.1,27.8,0,1237,1241,7679
1990,12,251806,309518,4547822,4485056,46520,15.2,36577,12,883071,361686,521385,8.1,19.7,757538,284893,472645,6.4,16.9,125533,2.8,33.8,0,26337,26475,171200
1990,13,108444,137562,2512865,2487945,17768,13,15063,11,443678,161299,282379,6.5,17.8,393838,138080,255758,5.5,15.8,49840,2,31.6,0,10128,10188,69692
1990,15,20775,25751,426380,414778,3227,12.8,2199,8.7,73774,27805,45969,6.7,17.8,50570,18469,32101,4.5,12.2,23204,5.6,24.4,0,1418,1421,11112
1990,16,19489,23039,295775,288998,3311,14.8,1991,8.9,54527,18554,35973,6.4,18.9,40973,13531,27442,4.7,14.2,13554,4.7,28.4,0,1388,1395,8422
1990,17,198556,239858,4586839,4534140,27028,11.4,21638,9.1,690104,243317,446787,5.4,15.2,584707,186785,397922,4.1,12.9,105397,2.3,25.8,0,14411,14472,98184
1990,18,92188,114595,2131181,2106302,12940,11.4,10020,8.8,313238,108421,204817,5.1,14.9,263479,82076,181403,3.9,12.5,49759,2.4,25,0,6922,6951,44788
1990,19,53791,65557,1007027,991671,6476,9.9,5322,8.2,142530,46380,96150,4.7,14.4,111818,34759,77059,3.5,11.3,30712,3.1,22.6,0,3704,3717,21913
1990,20,48532,58428,878666,864234,6412,11,6004,10.3,139839,50104,89735,5.8,16.2,110974,41398,69576,4.8,12.8,28865,3.4,25.6,0,4142,4156,23465
1990,21,57929,70283,1176302,1155358,8451,12.1,6669,9.6,193356,70528,122828,6.1,16.7,151467,52338,99129,4.5,13.1,41889,3.6,26.2,0,4701,4715,30148
1990,22,63913,78977,1249932,1224466,8939,11.4,8093,10.3,227081,80088,146993,6.5,18.5,176148,68473,107675,5.6,14.4,50933,4.1,28.8,0,5509,5561,38258
1990,23,25462,29606,414567,420075,3438,11.6,3415,11.5,58891,23721,35170,5.6,14,69907,21725,48182,5.2,16.6,-11016,-2.6,28,0,2405,2410,13710
1990,24,81789,100504,1806503,1786035,12822,12.9,9704,9.8,310234,112712,197522,6.3,17.4,269297,89879,179418,5,15.1,40937,2.3,30.2,0,6285,6319,47001
1990,25,117524,140130,2744968,2801266,14558,10.3,15630,11.1,359866,129901,229965,4.6,12.8,472463,145067,327396,5.2,16.9,-112597,-4.1,25.6,0,10847,10908,80959
1990,26,149076,183471,3373735,3352229,20782,11.4,16673,9.2,507827,183946,323881,5.5,15.1,464815,140614,324201,4.2,13.9,43012,1.2,27.8,0,11303,11365,73224
1990,27,80981,97753,1823146,1795142,11162,11.5,8687,9,285317,91717,193600,5.1,15.9,229308,80424,148884,4.5,12.8,56009,3.1,25.6,0,5609,5644,39262
1990,28,38524,46867,725091,714218,5585,12,4830,10.4,116124,39857,76267,5.6,16.3,94379,33961,60418,4.8,13.2,21745,3.1,26.4,0,3406,3428,19871
1990,29,94420,115207,1970549,1952712,13611,11.9,11140,9.8,304769,111852,192917,5.7,15.6,269096,85123,183973,4.4,13.8,35673,1.8,27.6,0,7453,7486,45704
1990,30,18796,21649,218307,213359,2583,12,2072,9.7,38164,13084,25080,6.1,17.9,28268,11051,17217,5.2,13.2,9896,4.7,26.4,0,1382,1383,6907
1990,31,32829,39007,578770,568260,4048,10.4,3409,8.8,85320,29321,55999,5.2,15,64299,21487,42812,3.8,11.3,21021,3.7,22.6,0,2272,2273,12667
1990,32,21800,25719,536940,516403,4281,17.1,2740,10.9,116231,36633,79598,7.1,22.5,75158,25914,49244,5,14.6,41073,7.9,29.2,0,1913,1922,15904
1990,33,25125,28975,444549,455024,3521,12,3955,13.5,61643,24597,37046,5.4,13.5,82593,27967,54626,6.1,18.2,-20950,-4.7,27,0,2886,2888,17445
1990,34,159964,185608,3197912,3202458,21494,11.6,19302,10.4,501500,187321,314179,5.8,15.7,510594,163199,347395,5.1,15.9,-9094,-0.2,31.4,0,13363,13396,82249
1990,35,26246,31208,410010,401338,4138,13.4,3404,11,76693,28895,47798,7.2,19.1,59349,23112,36237,5.8,14.8,17344,4.3,29.6,0,2243,2255,13287
1990,36,351934,405944,6990631,6982030,46931,11.6,42872,10.6,1052157,359067,693090,5.1,15.1,1034954,332651,702303,4.8,14.8,17203,0.3,29.6,0,31041,31176,187280
1990,37,116947,145997,2667789,2628527,18136,12.6,13775,9.5,432686,152507,280179,5.8,16.5,354162,125334,228828,4.8,13.5,78524,3,27,0,9366,9413,68490
1990,38,14394,16812,193821,190600,1609,9.6,1461,8.7,27762,8513,19249,4.5,14.6,21319,7877,13442,4.1,11.2,6443,3.4,22.4,0,1044,1045,4778
1990,39,174524,222305,4231414,4198647,23686,10.7,19488,8.8,608684,216348,392336,5.2,14.5,543150,170517,372633,4.1,12.9,65534,1.6,25.8,0,12957,13041,95646
1990,40,54368,65781,938967,921164,7968,12.2,7012,10.7,160012,57372,102640,6.2,17.4,124406,47688,76718,5.2,13.5,35606,3.9,27,0,4819,4831,27956
1990,41,59146,70345,1001944,962890,14931,22.6,6194,9.4,229232,121443,107789,12.6,23.8,151123,50403,100720,5.2,15.7,78109,8.1,31.4,0,4128,4159,27839
1990,42,204164,250224,4555487,4516192,26902,10.8,21437,8.6,653123,210718,442405,4.7,14.5,574534,178341,396193,3.9,12.7,78589,1.8,25.4,0,14589,14647,97080
1990,44,21626,24238,392269,398502,2690,11.1,2604,10.7,51551,19017,32534,4.8,12.9,64016,19475,44541,4.9,16.1,-12465,-3.2,25.8,0,1882,1883,10863
1990,45,56645,70208,1246630,1223846,8805,12.7,6911,9.9,205356,74075,131281,6.1,16.8,159790,54731,105059,4.5,13.1,45566,3.7,26.2,0,4751,4770,30049
1990,46,15488,17756,212179,206824,2088,11.9,1542,8.8,36187,13611,22576,6.6,17.5,25477,10083,15394,4.9,12.3,10710,5.2,24.6,0,1080,1081,5457
1990,47,80435,100697,1861733,1844231,12319,12.3,10252,10.3,295167,107860,187307,5.8,16,260162,87357,172805,4.7,14.1,35005,1.9,28.2,0,7047,7063,45448
1990,48,269514,346290,5799984,5693271,46282,13.5,38757,11.3,1128504,423327,705177,7.4,19.8,915077,368195,546882,6.5,16.1,213427,3.7,32.2,0,25945,26209,186064
1990,49,26102,31757,564421,550160,4189,13.3,3226,10.3,106096,36557,69539,6.6,19.3,77574,29327,48247,5.3,14.1,28522,5.2,28.2,0,2159,2171,16072
1990,50,15309,17187,215447,215990,2009,11.7,1789,10.4,31575,11434,20141,5.3,14.6,32661,11001,21660,5.1,15.1,-1086,-0.5,29.2,0,1326,1328,6384
1990,51,104373,132428,2310960,2283216,17340,13.3,12922,9.9,384906,143467,241439,6.3,16.9,329417,106542,222875,4.7,14.4,55489,2.5,28.8,0,8585,8640,53343
1990,53,94750,113374,1710032,1633703,29651,28.7,8909,8.6,446148,239874,206274,14.7,27.3,293489,128265,165224,7.9,18,152659,9.3,36,0,5722,5746,76956
1990,54,27960,33771,482311,474967,3837,11.4,3177,9.5,76630,27703,48927,5.8,16.1,61942,22680,39262,4.8,13,14688,3.1,26,0,2257,2262,13957
1990,55,90232,108203,1926269,1897836,11456,10.7,8970,8.4,273348,94143,179205,5,14.4,216482,71211,145271,3.8,11.4,56866,3,22.8,0,6099,6129,38512
1990,56,10838,12498,129359,126413,1461,11.8,1252,10.1,24021,7995,16026,6.3,19,18128,7545,10583,6,14.3,5893,4.7,28.6,0,823,824,3949
1991,01,62962,78721,1333422,1330914,9724,12.5,8231,10.6,213817,89491,124326,6.7,16.1,208800,73332,135468,5.5,15.7,5017,0.4,31.4,0,5175,5238,36661
1991,02,10628,12744,159969,156297,1933,15.6,1257,10.1,34266,12900,21366,8.3,21.9,26921,8097,18824,5.2,17.2,7345,4.7,34.4,0,724,726,4227
1991,04,62102,77582,1247868,1234743,11762,15.4,9233,12.1,254385,109364,145021,8.9,20.6,228137,80685,147452,6.5,18.5,26248,2.1,37,0,5808,5868,45391
1991,05,40619,48560,762331,753032,6132,12.8,4905,10.2,125038,53785,71253,7.1,16.6,106439,34904,71535,4.6,14.1,18599,2.5,28.2,0,3244,3267,20026
1991,06,535853,659054,10913237,11037302,92230,14.2,75868,11.7,1956156,788570,1167586,7.1,17.7,2204287,715727,1488560,6.5,20,-248131,-2.3,35.4,0,47126,47649,387619
1991,08,72125,86888,1272413,1255925,12798,15,9342,11,235388,99290,136098,7.9,18.7,202412,75714,126698,6,16.1,32976,2.6,32.2,0,5973,6061,41531
1991,09,68844,80861,1442513,1464471,8486,10.4,9420,11.6,204843,85906,118937,5.9,14,248759,76438,172321,5.2,17,-43916,-3,28,0,6023,6078,38537
1991,10,13870,16554,311611,312289,2302,14.2,1625,10,48962,22864,26098,7.3,15.7,50317,16622,33695,5.3,16.1,-1355,-0.4,31.4,0,970,984,5941
1991,11,14623,17558,387751,396999,1987,11.3,1914,10.9,51588,20022,31566,5,13,70084,18283,51801,4.6,17.7,-18496,-4.7,26,0,966,983,8076
1991,12,257912,318238,4525061,4537628,48435,15.4,39708,12.7,866665,392545,474120,8.7,19.1,891801,317107,574694,7,19.7,-25136,-0.6,38.2,0,25550,25897,179638
1991,13,110728,141028,2448939,2479409,19158,13.8,15727,11.3,417015,184111,232904,7.4,16.8,477954,173620,304334,7,19.3,-60939,-2.5,33.6,0,9452,9665,92591
1991,15,21514,26947,436864,432427,3547,13.5,2368,9,75367,33266,42101,7.7,17.4,66493,19376,47117,4.5,15.4,8874,2,30.8,0,1493,1510,10270
1991,16,20210,23992,306322,300810,3232,13.8,2238,9.5,57355,22403,34952,7.4,19.1,46330,15293,31037,5.1,15.4,11025,3.7,30.8,0,1384,1393,8255
1991,17,201406,244919,4572011,4577187,28231,11.6,23286,9.6,672100,272756,399344,6,14.7,682452,211359,471093,4.6,14.9,-10352,-0.2,29.4,0,14479,14640,109221
1991,18,93769,117452,2107816,2118027,13543,11.7,10656,9.2,297702,121954,175748,5.8,14.1,318124,94996,223128,4.5,15,-20422,-0.9,28.2,0,6926,7008,52981
1991,19,54774,67237,1027897,1017620,6972,10.5,5312,8,146806,50102,96704,4.9,14.4,126251,37525,88726,3.7,12.4,20555,2,24.8,0,3419,3455,20816
1991,20,48877,59283,880143,879003,7012,11.9,6116,10.4,137292,60093,77199,6.8,15.6,135011,46014,88997,5.2,15.4,2281,0.2,30.8,0,3863,3915,25690
1991,21,58665,72020,1182578,1179232,8739,12.3,6979,9.8,188773,80167,108606,6.8,16,182081,59560,122521,5.1,15.4,6692,0.6,30.8,0,4683,4719,35264
1991,22,65002,80890,1274266,1262182,9684,12.1,7905,9.9,228905,86306,142599,6.8,18.1,204737,75278,129459,6,16.2,24168,1.9,32.4,0,5069,5117,39181
1991,23,25173,29548,395942,404958,3368,11.4,3311,11.2,51511,21100,30411,5.2,12.7,69544,20433,49111,5,17.2,-18033,-4.5,25.4,0,2102,2109,11487
1991,24,82212,101909,1736688,1771072,12653,12.5,11195,11.1,268925,116400,152525,6.6,15.2,337695,109939,227756,6.2,19.1,-68770,-3.9,30.4,0,6824,6910,51592
1991,25,114170,137550,2574210,2655165,14169,10.2,16621,12,333741,128942,204799,4.9,12.6,495652,157859,337793,5.9,18.7,-161911,-6.1,25.2,0,10168,10311,77117
1991,26,150753,186622,3276463,3323912,20988,11.3,17816,9.6,461835,191905,269930,5.8,13.9,556732,163671,393061,4.9,16.7,-94897,-2.8,27.8,0,11298,11472,87323
1991,27,82803,100739,1804936,1814867,12134,12.2,9100,9.2,268030,112187,155843,6.2,14.8,287892,97851,190041,5.4,15.9,-19862,-1.1,29.6,0,5633,5714,52820
1991,28,39116,47929,734034,729352,5874,12.4,4921,10.4,116285,48507,67778,6.7,15.9,106921,35613,71308,4.9,14.7,9364,1.2,29.4,0,3118,3140,20628
1991,29,95513,117251,1985040,1975910,14140,12.2,12084,10.4,328546,119509,209037,6,16.6,310285,105549,204736,5.3,15.7,18261,0.9,31.4,0,7544,7647,54642
1991,30,19299,22338,221625,220000,2808,12.8,2105,9.6,37147,15863,21284,7.2,16.9,33897,11195,22702,5.1,15.4,3250,1.5,30.8,0,1397,1408,7192
1991,31,33400,40077,592764,585726,4464,11.3,3429,8.7,87919,35081,52838,6,15,73843,23795,50048,4.1,12.6,14076,2.4,25.2,0,2231,2264,14503
1991,32,22934,27226,546478,542356,4527,17.1,2992,11.3,101212,39713,61499,7.3,18.7,92967,27386,65581,5,17.1,8245,1.6,34.2,0,1936,1953,17740
1991,33,24446,28472,410699,423405,3439,12,3841,13.4,56742,25233,31509,6,13.4,82153,28585,53568,6.8,19.4,-25411,-6,26.8,0,2493,2517,17074
1991,34,158005,184425,3059380,3124754,20917,11.3,21786,11.8,450804,175021,275783,5.6,14.4,581553,178773,402780,5.7,18.6,-130749,-4.2,28.8,0,13612,13722,87088
1991,35,27094,32331,424875,417522,4573,14.4,3459,10.9,83905,38940,44965,9.3,20.1,69198,26929,42269,6.4,16.6,14707,3.5,33.2,0,2116,2129,14617
1991,36,350517,407232,6723065,6859689,47197,11.6,46332,11.4,940668,372391,568277,5.4,13.7,1213918,369220,844698,5.4,17.7,-273250,-4,27.4,0,31048,31215,202918
1991,37,118321,148645,2568995,2614322,18112,12.3,15405,10.5,360307,152642,207665,5.8,13.8,450962,143023,307939,5.5,17.2,-90655,-3.4,27.6,0,9695,9829,69780
1991,38,14520,17091,200127,197234,1811,10.7,1536,9.1,31928,13472,18456,6.8,16.2,26142,8848,17294,4.5,13.3,5786,2.9,26.6,0,977,981,5615
1991,39,176311,225884,4163505,4196084,24149,10.8,20380,9.1,567699,222206,345493,5.3,13.5,632857,197271,435586,4.7,15.1,-65158,-1.6,27,0,12631,12760,103279
1991,40,55933,67825,949669,944302,8695,13,6719,10.1,158280,66400,91880,7,16.8,147545,50642,96903,5.4,15.6,10735,1.2,31.2,0,4316,4351,28679
1991,41,60664,72684,1022839,1011444,10174,14.2,7709,10.8,189930,78666,111264,7.8,18.8,167140,59672,107468,5.9,16.5,22790,2.3,33,0,4868,4955,30992
1991,42,205750,253646,4509181,4538975,26772,10.6,23304,9.3,624456,243293,381163,5.4,13.8,684044,223119,460925,4.9,15.1,-59588,-1.3,27.6,0,14753,14985,107675
1991,44,21104,23742,374935,383606,2439,10.2,2896,12.1,50469,21496,28973,5.6,13.2,67813,19732,48081,5.1,17.7,-17344,-4.5,26.4,0,1836,1856,11803
1991,45,58022,72468,1228735,1236964,9557,13.4,7265,10.2,190490,89557,100933,7.2,15.4,206948,66002,140946,5.3,16.7,-16458,-1.3,30.8,0,4482,4531,32133
1991,46,15927,18430,224541,218618,2208,12.2,1526,8.4,38894,16034,22860,7.3,17.8,27047,8618,18429,3.9,12.4,11847,5.4,24.8,0,988,989,5264
1991,47,81672,103073,1847313,1853527,12947,12.7,10592,10.4,296543,130950,165593,7.1,16,308970,100794,208176,5.4,16.7,-12427,-0.7,32,0,6708,6785,53053
1991,48,277327,357380,5919818,5857767,50053,14.2,38985,11.1,1144470,467778,676692,8,19.5,1020369,393103,627266,6.7,17.4,124101,2.1,34.8,0,24110,24492,214374
1991,49,27233,33225,594461,579626,4739,14.6,3307,10.2,116996,44450,72546,7.7,20.2,87325,30313,57012,5.2,15.1,29671,5.1,30.2,0,2065,2082,18817
1991,50,15232,17207,205611,210592,1858,10.8,1832,10.7,26618,11213,15405,5.3,12.6,36579,11162,25417,5.3,17.4,-9961,-4.8,25.2,0,1192,1197,6894
1991,51,104776,134097,2222649,2266314,16840,12.6,15030,11.3,331332,145398,185934,6.4,14.6,418661,133978,284683,5.9,18.5,-87329,-3.9,29.2,0,9026,9141,62711
1991,53,98342,118435,1738450,1727614,17247,14.9,12110,10.5,319738,121174,198564,7,18.5,298066,104319,193747,6,17.3,21672,1.2,34.6,0,7441,7515,48589
1991,54,28321,34474,482716,481431,3985,11.7,3257,9.6,73483,33305,40178,6.9,15.3,70913,22048,48865,4.6,14.7,2570,0.6,29.4,0,2052,2073,13523
1991,55,92050,111392,1937222,1931269,12429,11.3,9237,8.4,263858,103347,160511,5.4,13.7,251952,76213,175739,3.9,13,11906,0.7,26,0,6022,6113,43264
1991,56,11227,13014,134775,132036,1681,13.2,1179,9.2,24528,9213,15315,7,18.6,19050,5751,13299,4.4,14.4,5478,4.2,28.8,0,759,762,3866
1992,01,63918,80283,1357833,1346402,10063,12.6,8215,10.3,220619,76427,144192,5.7,16.4,197756,67093,130663,5,14.7,22863,1.7,29.4,0,5494,5574,37434
1992,02,10879,13231,164416,162050,1968,15.1,1419,10.9,36008,12401,23607,7.7,22.2,31275,9499,21776,5.9,19.3,4733,2.9,38.6,0,846,860,5463
1992,04,63128,78859,1249829,1248051,11685,14.9,10040,12.8,246578,99526,147052,8,19.8,243023,98726,144297,7.9,19.5,3555,0.3,39,0,6257,6434,43024
1992,05,41160,49488,783490,773067,6354,12.9,5200,10.6,133093,44686,88407,5.8,17.2,112247,38106,74141,4.9,14.5,20846,2.7,29,0,3558,3614,21298
1992,06,529679,656532,10600609,10732102,87403,13.3,85165,12.9,1980636,813263,1167373,7.6,18.5,2243623,797104,1446519,7.4,20.9,-262987,-2.4,37,0,54681,55671,436805
1992,08,74094,89165,1315507,1292916,12983,14.7,10311,11.7,254539,100552,153987,7.8,19.7,209357,84683,124674,6.5,16.2,45182,3.5,32.4,0,6499,6612,45003
1992,09,67353,79633,1405742,1423706,8432,10.5,9147,11.4,197571,68031,129540,4.8,13.9,233498,72314,161184,5.1,16.4,-35927,-2.5,27.8,0,5837,5916,36640
1992,10,14035,16883,301588,306365,2285,13.7,1872,11.2,44535,16844,27691,5.5,14.5,54089,20740,33349,6.8,17.7,-9554,-3.2,29,0,1078,1084,6205
1992,11,14639,17712,402191,394956,1985,11.2,1784,10.1,72706,36171,36535,9.2,18.4,58236,16642,41594,4.2,14.7,14470,3.7,29.4,0,1001,1015,8118
1992,12,263140,324622,4556106,4541774,50409,15.7,42391,13.2,904025,383699,520326,8.4,19.9,875361,361525,513836,8,19.3,28664,0.6,38.6,0,28019,28545,186814
1992,13,113048,143866,2504079,2476106,20113,14.1,16666,11.7,468312,180370,287942,7.3,18.9,412366,169463,242903,6.8,16.7,55946,2.2,33.4,0,10233,10466,78970
1992,15,21464,27167,447013,441837,3140,11.6,2794,10.3,76863,25427,51436,5.8,17.4,66511,20482,46029,4.6,15.1,10352,2.3,30.2,0,1756,1788,10274
1992,16,21016,24955,324831,315744,3552,14.5,2485,10.1,65196,26722,38474,8.5,20.6,47021,15977,31044,5.1,14.9,18175,5.7,29.8,0,1591,1611,9548
1992,17,202758,247905,4605188,4579284,28583,11.6,24543,10,755954,274538,481416,6,16.5,704145,225520,478625,4.9,15.4,51809,1.1,30.8,0,15142,15396,108970
1992,18,94728,119531,2154539,2130456,13643,11.5,11239,9.5,345245,129067,216178,6.1,16.2,297080,98676,198404,4.6,13.9,48165,2.3,27.8,0,7282,7408,51973
1992,19,55206,68184,1026789,1023283,7059,10.4,5932,8.8,156014,57266,98748,5.6,15.2,149002,47465,101537,4.6,14.6,7012,0.6,29.2,0,3821,3875,24541
1992,20,49393,60233,887120,883294,7109,11.9,5939,9.9,140103,53039,87064,6,15.9,132451,46138,86313,5.2,15,7652,0.9,30,0,3831,3893,26719
1992,21,59039,72943,1196676,1189978,8704,12,7525,10.4,181731,63288,118443,5.3,15.3,168335,58632,109703,4.9,14.1,13396,1.2,28.2,0,5114,5174,33801
1992,22,65815,82139,1295888,1284338,9854,12.1,8308,10.2,238258,80995,157263,6.3,18.6,215158,74304,140854,5.8,16.8,23100,1.8,33.6,0,5292,5421,40216
1992,23,24977,29470,387427,391145,3375,11.4,3238,11,56079,20899,35180,5.3,14.3,63515,22696,40819,5.8,16.2,-7436,-1.9,28.6,0,2054,2093,10969
1992,24,82786,103147,1712085,1723791,12701,12.4,11132,10.8,285511,107603,177908,6.2,16.6,308923,97369,211554,5.6,17.9,-23412,-1.3,33.2,0,6609,6755,46573
1992,25,112484,136582,2545727,2559000,14705,10.7,14970,10.9,383484,135569,247915,5.3,15,410031,135513,274518,5.3,16,-26547,-1,30,0,9271,9426,66267
1992,26,152282,189397,3326882,3301018,21177,11.2,17652,9.4,520263,167285,352978,5.1,15.8,468535,150402,318133,4.6,14.2,51728,1.6,28.4,0,10678,10834,76009
1992,27,83751,102474,1843186,1822713,12065,11.9,9970,9.8,291031,97946,193085,5.4,16,250084,87576,162508,4.8,13.7,40947,2.3,27.4,0,6204,6324,44057
1992,28,39423,48416,739559,734471,5798,12,5075,10.5,117218,37542,79676,5.1,16,107041,35435,71606,4.8,14.6,10177,1.4,29.2,0,3314,3354,19983
1992,29,96336,118633,1993317,1987304,14246,12.1,12404,10.5,310842,108320,202522,5.5,15.6,298818,97840,200978,4.9,15,12024,0.6,30,0,7913,8040,48897
1992,30,19780,23061,235560,228382,3069,13.5,2302,10.1,45383,15091,30292,6.6,19.9,31027,12150,18877,5.3,13.6,14356,6.3,27.2,0,1533,1548,7912
1992,31,33831,40666,599589,594127,4442,11,3692,9.1,89742,30305,59437,5.1,15.1,78818,25394,53424,4.3,13.3,10924,1.8,26.6,0,2366,2411,14040
1992,32,23416,28079,546774,546736,4589,16.6,3592,13,92376,39364,53012,7.2,16.9,92300,30477,61823,5.6,16.9,76,0,33.8,0,2343,2367,16144
1992,33,24211,28590,413152,411639,3616,12.7,3332,11.7,68106,25656,42450,6.2,16.5,65079,22538,42541,5.5,15.8,3027,0.7,31.6,0,2250,2292,13925
1992,34,157103,183921,3040788,3044202,21104,11.4,20403,11.1,502362,159478,342884,5.2,16.5,509190,163938,345252,5.4,16.7,-6828,-0.2,33,0,12842,12978,73121
1992,35,27468,33023,435583,428861,4599,14.1,3677,11.2,89835,34614,55221,8.1,20.9,76390,27287,49103,6.4,17.8,13445,3.1,35.6,0,2278,2322,13989
1992,36,345484,403364,6668444,6676973,46121,11.4,47403,11.7,1075981,381653,694328,5.7,16.1,1093039,368634,724405,5.5,16.4,-17058,-0.3,32.2,0,32517,33001,197188
1992,37,119096,150549,2627581,2596790,17939,12,15352,10.2,425304,149148,276156,5.7,16.4,363722,131811,231911,5.1,14,61582,2.4,28,0,9813,9961,60525
1992,38,14514,17226,205032,202318,1825,10.6,1612,9.4,31503,10931,20572,5.4,15.6,26075,8949,17126,4.4,12.9,5428,2.7,25.8,0,1047,1060,5142
1992,39,176694,227682,4164728,4161441,23913,10.5,21555,9.5,593273,194745,398528,4.7,14.3,586698,181546,405152,4.4,14.1,6575,0.2,28.2,0,13219,13463,86135
1992,40,56510,68949,953182,950584,8789,12.8,7390,10.8,160250,59875,100375,6.3,16.9,155053,58979,96074,6.2,16.3,5197,0.6,32.6,0,5040,5130,31593
1992,41,61952,74465,1024419,1022136,10166,13.8,8043,10.9,178424,68390,110034,6.7,17.5,173857,59332,114525,5.8,17,4567,0.5,34,0,5131,5196,32875
1992,42,204368,253696,4473809,4488384,25601,10.1,24738,9.7,636161,227241,408920,5.1,14.2,665312,214803,450509,4.8,14.8,-29151,-0.6,28.4,0,15873,16115,103202
1992,44,20701,23354,362661,367863,2590,11,2734,11.6,51853,18093,33760,4.9,14.1,62258,22229,40029,6,16.9,-10405,-2.8,28.2,0,1775,1803,12307
1992,45,58601,73449,1250968,1241171,9238,12.6,7882,10.8,198684,75754,122930,6.1,16,179089,58743,120346,4.7,14.4,19595,1.6,28.8,0,5055,5122,31848
1992,46,16093,18764,234098,229407,2201,11.8,1815,9.7,39960,13577,26383,5.9,17.4,30577,11517,19060,5,13.3,9383,4.1,26.6,0,1185,1196,6948
1992,47,82534,104471,1892959,1868443,13044,12.6,11228,10.8,321539,109151,212388,5.8,17.2,272507,99882,172625,5.3,14.6,49032,2.6,29.2,0,7132,7246,49124
1992,48,282598,365314,5993734,5950058,51501,14.2,42127,11.6,1156126,470128,685998,7.9,19.4,1068775,398255,670520,6.7,18,87351,1.4,36,0,26555,27201,206550
1992,49,28181,34343,612770,603564,4999,14.8,3789,11.2,118271,43472,74799,7.2,19.6,99860,41182,58678,6.8,16.5,18411,3.1,33,0,2414,2449,23583
1992,50,15163,17195,206718,205790,1903,11.1,1776,10.3,31247,11337,19910,5.5,15.2,29391,9135,20256,4.4,14.3,1856,0.9,28.6,0,1194,1200,6082
1992,51,105795,135803,2238623,2231301,17097,12.7,14825,11,374294,141088,233206,6.3,16.8,359651,125790,233861,5.6,16.1,14643,0.7,32.2,0,8969,9197,62989
1992,53,101511,122631,1788354,1761545,18240,15.1,13279,11,352641,119751,232890,6.8,20,299023,109327,189696,6.2,17,53618,3,34,0,8458,8554,50743
1992,54,28485,34743,480305,481350,3828,11,3382,9.8,72749,25278,47471,5.3,15.1,74839,26888,47951,5.6,15.5,-2090,-0.4,30.2,0,2104,2121,12299
1992,55,92741,112804,1970630,1954788,11883,10.6,10101,9,273079,86215,186864,4.4,14,241395,79130,162265,4,12.3,31684,1.7,24.6,0,6406,6480,38972
1992,56,11513,13338,137108,135874,1710,13,1301,9.9,24911,8672,16239,6.4,18.3,22442,7409,15033,5.5,16.5,2469,1.8,33,0,757,764,4371
1993,01,65394,81689,1402372,1383184,9482,11.7,7837,9.7,217685,64949,152736,4.7,15.7,179308,61198,118110,4.4,13,38377,2.7,26,0,5343,5360,31016
1993,02,11184,13481,167106,165637,1737,13,1451,10.9,31638,9464,22174,5.7,19.1,28699,9148,19551,5.5,17.3,2939,1.8,34.6,0,840,848,4586
1993,04,65112,80516,1298549,1274754,11194,14,9275,11.6,249849,90983,158866,7.1,19.6,202258,78183,124075,6.1,15.9,47591,3.7,31.8,0,5987,6028,37389
1993,05,42387,50628,811999,797039,6164,12.3,4870,9.7,130417,42142,88275,5.3,16.4,100497,35748,64749,4.5,12.6,29920,3.8,25.2,0,3445,3489,18979
1993,06,523374,645597,10523702,10547691,75603,11.6,82362,12.7,1912726,669902,1242824,6.4,18.1,1960704,717950,1242754,6.8,18.6,-47978,-0.5,36.2,0,53343,54099,337326
1993,08,77907,92656,1376926,1345000,13173,14.5,9490,10.4,257230,86970,170260,6.5,19.1,193377,73079,120298,5.4,14.4,63853,4.7,28.8,0,6093,6127,35660
1993,09,67538,79579,1401099,1402788,7808,9.8,7696,9.7,206594,59721,146873,4.3,14.7,209972,60131,149841,4.3,15,-3378,-0.3,29.4,0,5023,5054,29100
1993,10,14343,17100,303601,302401,2026,11.9,1745,10.3,47459,16479,30980,5.4,15.7,45060,15455,29605,5.1,14.9,2399,0.8,29.8,0,1045,1047,6557
1993,11,14585,17491,427287,414809,1618,9.2,1813,10.3,78371,16050,62321,3.9,18.9,53416,18062,35354,4.4,12.9,24955,6,25.8,0,927,931,6106
1993,12,272178,332350,4730699,4644368,48544,14.8,39997,12.2,957577,368147,589430,7.9,20.6,784916,312395,472521,6.7,16.9,172661,3.7,33.8,0,27778,28105,175123
1993,13,117021,147510,2577638,2540489,19231,13.2,15262,10.5,448717,162589,286128,6.4,17.7,374420,135669,238751,5.3,14.7,74297,3,29.4,0,9955,10003,66232
1993,15,21464,27064,431256,438664,2824,10.4,2806,10.4,59021,21333,37688,4.9,13.5,73836,22087,51749,5,16.8,-14815,-3.3,27,0,1840,1848,10282
1993,16,21841,25761,333957,329085,3427,13.5,2518,9.9,59000,20819,38181,6.3,17.9,49256,16253,33003,4.9,15,9744,2.9,30,0,1644,1646,9368
1993,17,206074,250735,4621690,4609541,26409,10.6,22911,9.2,695031,233014,462017,5.1,15.1,670734,205150,465584,4.5,14.6,24297,0.5,29.2,0,14781,14889,89863
1993,18,96817,121418,2206872,2180336,12591,10.5,10483,8.7,324332,94277,230055,4.3,14.9,271261,86940,184321,4,12.4,53071,2.5,24.8,0,7089,7135,43290
1993,19,55783,68639,1045160,1035736,6226,9.1,5617,8.2,137815,41013,96802,4,13.3,118969,35761,83208,3.5,11.5,18846,1.8,23,0,3768,3787,19290
1993,20,50181,60925,896667,891512,6421,10.6,5599,9.2,129057,41789,87268,4.7,14.5,118747,39453,79294,4.4,13.3,10310,1.2,26.6,0,3722,3753,21944
1993,21,60115,73934,1236883,1216362,8334,11.3,7173,9.8,195988,66685,129303,5.5,16.1,154945,56104,98841,4.6,12.7,41043,3.4,25.4,0,4861,4885,28067
1993,22,67301,83407,1307704,1301148,9085,11,7729,9.3,220413,73452,146961,5.6,16.9,207303,67445,139858,5.2,15.9,13110,1,31.8,0,5236,5260,38046
1993,23,25253,29690,403791,395352,3264,11,2906,9.8,66653,24220,42433,6.1,16.9,49775,17940,31835,4.5,12.6,16878,4.3,25.2,0,1917,1940,9508
1993,24,84307,103875,1706618,1708351,11932,11.5,10935,10.6,269415,95294,174121,5.6,15.8,272880,91177,181703,5.3,16,-3465,-0.2,31.6,0,6522,6583,45729
1993,25,113330,136982,2589716,2567055,13717,10,13077,9.6,402009,125931,276078,4.9,15.7,356688,116624,240064,4.5,13.9,45321,1.8,27.8,0,8411,8519,51185
1993,26,154549,191270,3399508,3361977,19527,10.3,17211,9,507409,154486,352923,4.6,15.1,432347,134966,297381,4,12.9,75062,2.2,25.8,0,11274,11357,67692
1993,27,86216,104867,1905884,1874729,11352,11,8712,8.4,291989,98980,193009,5.3,15.6,229678,75485,154193,4,12.3,62311,3.3,24.6,0,5627,5693,36385
1993,28,40418,49450,768595,754275,5852,12,4752,9.7,126665,45463,81202,6,16.8,98025,38000,60025,5,13,28640,3.8,26,0,3410,3418,20646
1993,29,98232,120257,2006838,1999829,13511,11.3,11697,9.8,294301,95582,198719,4.8,14.7,280284,96931,183353,4.8,14,14017,0.7,28,0,7881,7949,49493
1993,30,20244,23467,242211,238202,2807,12.1,2319,10,43062,15731,27331,6.6,18.1,35044,11835,23209,5,14.7,8018,3.4,29.4,0,1586,1596,7884
1993,31,34218,41023,613514,606482,4003,9.8,3553,8.7,86854,26530,60324,4.4,14.3,72792,21526,51266,3.5,12,14062,2.3,24,0,2398,2409,11995
1993,32,24180,28788,569375,557565,4404,15.5,3532,12.4,101870,40568,61302,7.3,18.3,78250,29621,48629,5.3,14,23620,4.3,28,0,2289,2322,17443
1993,33,24402,28745,419626,416203,3244,11.3,3006,10.5,64084,21454,42630,5.2,15.4,57239,19890,37349,4.8,13.8,6845,1.6,27.6,0,1976,1984,9353
1993,34,159542,186014,3058656,3051256,20496,11.1,18032,9.7,493320,153993,339327,5,16.2,478520,149481,329039,4.9,15.7,14800,0.5,31.4,0,11983,12029,64480
1993,35,28429,33868,450567,442894,4252,12.7,3395,10.2,82844,28707,54137,6.5,18.7,67498,23351,44147,5.3,15.2,15346,3.5,30.4,0,2255,2258,11832
1993,36,346038,403359,6587485,6618134,44518,11,43521,10.8,1006786,339819,666967,5.1,15.2,1068085,320965,747120,4.8,16.1,-61299,-0.9,30.4,0,30398,30582,165063
1993,37,121364,152781,2701297,2665585,16716,11,14088,9.3,406053,124381,281672,4.7,15.2,334630,110538,224092,4.1,12.6,71423,2.6,25.2,0,9465,9536,56224
1993,38,14735,17451,212012,208522,1696,9.8,1431,8.3,30326,9879,20447,4.7,14.5,23345,7644,15701,3.7,11.2,6981,3.3,22.4,0,976,978,4535
1993,39,179233,228860,4248093,4206104,22123,9.7,20558,9,628008,191069,436939,4.5,14.9,544030,181386,362644,4.3,12.9,83978,2,25.8,0,12654,12784,77428
1993,40,57797,69955,976190,964462,8068,11.6,6921,10,159179,56347,102832,5.8,16.5,135723,48341,87382,5,14.1,23456,2.4,28.2,0,4652,4674,24824
1993,41,63624,75844,1053561,1038875,9445,12.6,7806,10.4,180417,59020,121397,5.7,17.4,151045,51948,99097,5,14.5,29372,2.9,29,0,5056,5084,25547
1993,42,204517,253027,4498391,4486581,22871,9,22817,9,622105,199415,422690,4.4,13.9,598484,186450,412034,4.2,13.3,23621,0.6,26.6,0,15039,15156,91771
1993,44,21054,23688,372082,367391,2581,11,2234,9.5,57474,21994,35480,6,15.6,48091,17028,31063,4.6,13.1,9383,2.5,26.2,0,1463,1468,7915
1993,45,59863,74751,1275878,1264276,8759,11.8,7283,9.8,186416,63611,122805,5,14.7,163212,55605,107607,4.4,12.9,23204,1.8,25.8,0,4886,4910,25552
1993,46,16460,19109,244366,239186,2029,10.7,1650,8.7,39418,14321,25097,6,16.5,29057,10676,18381,4.5,12.1,10361,4.4,24.2,0,1115,1125,5551
1993,47,84669,106500,1945176,1918641,12427,11.8,10128,9.6,314912,102637,212275,5.3,16.4,261841,85139,176702,4.4,13.6,53071,2.8,27.2,0,6705,6787,42833
1993,48,290051,371330,6167530,6078760,47588,12.9,40533,11,1184264,410514,773750,6.8,19.5,1006723,373822,632901,6.1,16.6,177541,2.9,33.2,0,26186,26434,182144
1993,49,29422,35529,647937,630258,4941,14.1,3617,10.4,116802,38700,78102,6.1,18.5,81443,33761,47682,5.4,12.9,35359,5.6,25.8,0,2383,2397,18113
1993,50,15434,17460,213816,210647,1932,11.2,1660,9.6,31433,10379,21054,4.9,14.9,25095,9491,15604,4.5,11.9,6338,3,23.8,0,1142,1144,5405
1993,51,108229,137903,2384785,2310575,15718,11.5,13294,9.7,467445,127448,339997,5.5,20.2,319025,104246,214779,4.5,13.8,148420,6.4,27.6,0,8403,8458,48035
1993,53,104643,125528,1829761,1817669,16684,13.4,13251,10.7,304360,106150,198210,5.8,16.7,280177,96683,183494,5.3,15.4,24183,1.3,30.8,0,8618,8687,48839
1993,54,28810,35012,486757,483328,3487,10,3143,9,71006,21231,49775,4.4,14.7,64147,21332,42815,4.4,13.3,6859,1.4,26.6,0,2091,2107,11248
1993,55,94771,114878,2027296,1999055,11771,10.3,9501,8.3,287633,89099,198534,4.5,14.4,231153,77760,153393,3.9,11.6,56480,2.8,23.2,0,6420,6497,39149
1993,56,11868,13822,140856,139356,1855,13.7,1337,9.8,25420,10617,14803,7.6,18.2,22419,7634,14785,5.5,16.1,3001,2.1,32.2,0,876,885,4694
1994,01,67204,83751,1431114,1415009,10389,12.6,8070,9.8,221668,84306,137362,6,15.7,189457,63659,125798,4.5,13.4,32211,2.3,26.8,0,5492,5518,36087
1994,02,11511,13796,171500,169205,1814,13.3,1437,10.5,34015,12698,21317,7.5,20.1,29425,9253,20172,5.5,17.4,4590,2.7,34.8,0,841,847,3908
1994,04,67685,83748,1386223,1341461,12639,15.4,9122,11.1,292183,113564,178619,8.5,21.8,202658,77888,124770,5.8,15.1,89525,6.7,30.2,0,6185,6204,39110
1994,05,43467,52021,831571,821074,6622,12.9,5046,9.8,133751,52223,81528,6.4,16.3,112757,45335,67422,5.5,13.7,20994,2.6,27.4,0,3616,3628,24531
1994,06,522330,643643,10463271,10483851,80453,12.5,79079,12.3,1801794,700042,1101752,6.7,17.2,1842954,682970,1159984,6.5,17.6,-41160,-0.4,34.4,0,51095,51500,361010
1994,08,81787,97238,1434234,1404918,14746,15.5,9880,10.4,266776,104037,162739,7.4,19,208143,80050,128093,5.7,14.8,58633,4.2,29.6,0,6642,6670,39229
1994,09,67788,79927,1377582,1386909,8129,10.2,7555,9.5,190841,61086,129755,4.4,13.8,209494,69347,140147,5,15.1,-18653,-1.3,27.6,0,4994,5017,37964
1994,10,14714,17592,329222,316508,2201,12.7,1670,9.6,71292,17330,53962,5.5,22.5,45864,11910,33954,3.8,14.5,25428,8,29,0,1022,1022,5436
1994,11,14706,17665,407984,419062,1787,10.2,1568,8.9,53812,19632,34180,4.7,12.8,75968,14736,61232,3.5,18.1,-22156,-5.3,25.6,0,903,924,5120
1994,12,278292,339954,4914736,4817216,49400,14.7,40623,12.1,952151,369007,583144,7.7,19.8,757112,289054,468058,6,15.7,195039,4.1,31.4,0,28951,29079,175612
1994,13,120395,151723,2682828,2625414,20675,13.8,16053,10.7,476677,181930,294747,6.9,18.2,361850,140539,221311,5.4,13.8,114827,4.4,27.6,0,10626,10682,66569
1994,15,21493,27075,422268,426549,2794,10.3,2674,9.9,60556,26245,34311,6.2,14.2,69118,25343,43775,5.9,16.2,-8562,-2,28.4,0,1746,1780,13709
1994,16,23087,27136,356299,344819,4031,15.2,2519,9.5,68827,25521,43306,7.4,20,45866,16801,29065,4.9,13.3,22961,6.7,26.6,0,1702,1713,9791
1994,17,209382,254937,4733047,4674579,27674,10.9,22759,9,712239,244959,467280,5.2,15.2,595303,197026,398277,4.2,12.7,116936,2.5,25.4,0,14934,14986,95938
1994,18,98822,123919,2260498,2233858,13463,11,10684,8.7,335349,112216,223133,5,15,282068,97635,184433,4.4,12.6,53281,2.4,25.2,0,7144,7190,41701
1994,19,56457,69542,1065085,1054185,6899,10,5752,8.3,146704,49070,97634,4.7,13.9,124905,44435,80470,4.2,11.8,21799,2.1,23.6,0,3879,3893,20341
1994,20,51161,62065,926285,911281,7055,11.5,5763,9.4,143740,51368,92372,5.6,15.8,113733,40293,73440,4.4,12.5,30007,3.3,25,0,3875,3920,21570
1994,21,61120,75269,1270609,1253328,8584,11.5,7037,9.4,197247,71825,125422,5.7,15.7,162684,53943,108741,4.3,13,34563,2.7,26,0,4848,4862,30478
1994,22,68703,85118,1343405,1324235,10009,11.9,8060,9.6,226120,83022,143098,6.3,17.1,187780,61101,126679,4.6,14.2,38340,2.9,28.4,0,5422,5452,34384
1994,23,25592,30119,408726,405680,3454,11.6,2885,9.6,62425,21311,41114,5.3,15.4,56333,19396,36937,4.8,13.9,6092,1.5,27.8,0,2003,2007,11389
1994,24,85659,105413,1727732,1715818,12274,11.7,10447,10,283704,100420,183284,5.9,16.5,259878,88729,171149,5.2,15.1,23826,1.4,30.2,0,6504,6575,40183
1994,25,115026,138955,2613310,2600319,14973,10.9,12678,9.2,390689,124243,266446,4.8,15,364707,117629,247078,4.5,14,25982,1,28,0,8193,8227,56955
1994,26,157355,194789,3487939,3444715,20743,10.7,16779,8.7,532899,180540,352359,5.2,15.5,446451,163418,283033,4.7,13,86448,2.5,26,0,11186,11307,73811
1994,27,88527,107753,1956117,1929655,12103,11.4,8942,8.4,285269,94187,191082,4.9,14.8,232347,79639,152708,4.1,12,52922,2.8,24,0,5858,5884,40071
1994,28,40993,50131,816122,791400,6016,12.1,5173,10.4,149353,62745,86608,7.9,18.9,99908,36863,63045,4.7,12.6,49445,6.3,25.2,0,3688,3704,19477
1994,29,100222,122714,2064775,2035599,14935,12.3,12102,10,319265,109709,209556,5.4,15.7,260914,92012,168902,4.5,12.8,58351,2.9,25.6,0,8293,8322,49093
1994,30,20871,24169,245317,244093,3088,13,2292,9.6,39818,15227,24591,6.2,16.3,37369,12682,24687,5.2,15.3,2449,1,30.6,0,1615,1615,7487
1994,31,34734,41715,628608,620506,4384,10.6,3548,8.6,91746,33018,58728,5.3,14.8,75543,27913,47630,4.5,12.2,16203,2.6,24.4,0,2421,2429,13544
1994,32,25550,30321,620154,594536,5006,16.9,3372,11.4,132278,47095,85183,7.9,22.2,81042,34195,46847,5.8,13.6,51236,8.6,27.2,0,2298,2304,22040
1994,33,24930,29374,437814,428459,3642,12.5,2896,10,72133,24228,47905,5.7,16.8,53423,19791,33632,4.6,12.5,18710,4.3,25,0,1922,1923,9644
1994,34,161132,188124,3063311,3059172,21358,11.4,18728,10,465701,166225,299476,5.4,15.2,457423,158587,298836,5.2,15,8278,0.2,30,0,12256,12337,77345
1994,35,29254,34918,469827,459751,4758,13.8,3581,10.4,88327,33715,54612,7.3,19.2,68176,25703,42473,5.6,14.8,20151,4.4,29.6,0,2489,2497,14218
1994,36,346091,404479,6571558,6575682,45895,11.4,43644,10.8,961090,337489,623601,5.1,14.6,969338,319700,649638,4.9,14.7,-8248,-0.1,29.2,0,30401,30566,176252
1994,37,124616,156906,2807228,2752790,18552,12,13896,9,433376,154076,279300,5.6,15.7,324500,110356,214144,4,11.8,108876,3.9,23.6,0,9470,9514,58547
1994,38,14999,17739,218133,214997,1747,9.9,1437,8.2,30620,9451,21169,4.4,14.2,24350,7487,16863,3.5,11.3,6270,2.9,22.6,0,978,980,4376
1994,39,182111,232762,4325218,4273013,24152,10.5,19761,8.6,639049,222206,416843,5.2,15,534639,171797,362842,4,12.5,104410,2.5,25,0,12673,12805,77492
1994,40,59055,71479,995648,985381,8687,12.3,6913,9.8,158742,57988,100754,5.9,16.1,138207,47902,90305,4.9,14,20535,2.1,28,0,4906,4911,27235
1994,41,66290,79009,1107557,1080056,11027,14.2,7610,9.8,197672,74720,122952,6.9,18.3,142669,51367,91302,4.8,13.2,55003,5.1,26.4,0,5071,5084,26370
1994,42,204123,253624,4513312,4500087,23743,9.4,22356,8.8,626620,219667,406953,4.9,13.9,600170,206850,393320,4.6,13.3,26450,0.6,26.6,0,14883,14995,100223
1994,44,21332,23939,365761,369123,2666,11.2,2385,10,53350,21981,31369,6,14.5,60073,19637,40436,5.3,16.3,-6723,-1.8,29,0,1601,1605,9608
1994,45,60991,76229,1317363,1295372,9211,12.2,7440,9.9,211995,84016,127979,6.5,16.4,168012,61326,106686,4.7,13,43983,3.4,26,0,5042,5059,32212
1994,46,16860,19622,252284,248034,2288,11.8,1685,8.7,40007,15416,24591,6.2,16.1,31507,11968,19539,4.8,12.7,8500,3.4,25.4,0,1175,1178,7284
1994,47,86567,108939,2005611,1974443,12984,12.1,10231,9.5,321109,122031,199078,6.2,16.3,258773,96074,162699,4.9,13.1,62336,3.2,26.2,0,6919,6955,45748
1994,48,297469,380583,6287451,6221921,50661,13.5,40123,10.7,1120272,432105,688167,6.9,18,989213,347802,641411,5.6,15.9,131059,2.1,31.8,0,26915,27054,172658
1994,49,31010,37419,689037,668105,5781,15.9,3802,10.4,128131,47354,80777,7.1,19.2,86267,34331,51936,5.1,12.9,41864,6.3,25.8,0,2613,2622,19701
1994,50,15671,17725,217439,215493,1922,10.9,1583,9,30094,9996,20098,4.6,14,26202,9178,17024,4.3,12.2,3892,1.8,24.4,0,1082,1087,4970
1994,51,110799,140918,2343620,2363292,16525,11.9,13195,9.5,371711,135017,236694,5.7,15.7,411055,104294,306761,4.4,17.4,-39344,-1.7,31.4,0,8361,8400,46036
1994,53,107728,129097,1859522,1843105,17889,14.1,13678,10.7,310334,113646,196688,6.2,16.8,277500,87998,189502,4.8,15.1,32834,1.7,30.2,0,9127,9150,48116
1994,54,29426,35811,498339,492295,3863,10.9,2961,8.4,76370,27317,49053,5.5,15.5,64281,21064,43217,4.3,13.1,12089,2.4,26.2,0,1982,1987,10466
1994,55,96234,116838,2075218,2049898,11975,10.3,9661,8.3,277456,94337,183119,4.6,13.5,226817,69270,157547,3.4,11.1,50639,2.4,22.2,0,6566,6604,38191
1994,56,12355,14366,147284,143943,1862,13.2,1260,8.9,26883,10682,16201,7.4,18.7,20200,6685,13515,4.6,14,6683,4.7,28,0,849,851,4112
1995,01,68976,85909,1505044,1467007,10622,12.5,8166,9.6,250829,86798,164031,5.9,17.1,174755,60000,114755,4.1,11.9,76074,5.2,23.8,0,5662,5705,33571
1995,02,11847,14143,174360,172692,1882,13.5,1472,10.5,31134,11715,19419,6.8,18,27797,8862,18935,5.1,16.1,3337,1.9,32.2,0,943,952,4957
1995,04,70159,86610,1479744,1432500,12940,15.2,9572,11.2,294898,114600,180298,8,20.6,200410,74201,126209,5.2,14,94488,6.6,28,0,6436,6540,41490
1995,05,44595,53484,874829,852651,6889,13.1,5251,10,146210,50414,95796,5.9,17.1,101855,41891,59964,4.9,11.9,44355,5.2,23.8,0,3749,3754,23336
1995,06,526482,648641,10771139,10614063,82358,12.7,73802,11.4,1882074,667725,1214349,6.3,17.7,1567923,561589,1006334,5.3,14.8,314151,2.9,29.6,0,48884,49295,295961
1995,08,85450,101591,1523210,1478714,15212,15.3,10433,10.5,298346,119087,179259,8.1,20.2,209353,74051,135302,5,14.2,88993,6,28.4,0,6966,6988,42727
1995,09,68746,81012,1392839,1383830,8641,10.7,7346,9.1,197034,73542,123492,5.3,14.2,179016,56813,122203,4.1,12.9,18018,1.3,25.8,0,4784,4839,25884
1995,10,15180,18141,323278,314074,2319,13,1724,9.7,56080,17283,38797,5.5,17.9,37672,13275,24397,4.2,12,18408,5.9,24,0,1087,1092,6034
1995,11,14755,17774,407821,407790,1801,10.2,1653,9.3,57000,17561,39439,4.3,14,56939,17520,39419,4.3,14,61,0,28,0,923,929,7438
1995,12,283724,346872,5119849,5010695,49651,14.5,41223,12,1005605,416656,588949,8.3,20.1,787296,308071,479225,6.1,15.7,218309,4.4,31.4,0,29295,29457,180357
1995,13,124444,156989,2857372,2770099,21751,14.1,15910,10.3,537792,211358,326434,7.6,19.4,363247,140209,223038,5.1,13.1,174545,6.3,26.2,0,10532,10585,71666
1995,15,21547,27194,422242,421647,2864,10.6,2637,9.7,57737,25371,32366,6,13.7,56546,18763,37783,4.4,13.4,1191,0.3,26.8,0,1787,1796,8445
1995,16,24017,28116,367896,361497,3978,14.4,2862,10.4,65084,24536,40548,6.8,18,52286,21718,30568,6,14.5,12798,3.5,29,0,1934,1939,9114
1995,17,213113,259721,4870809,4800455,28881,11.2,23320,9.1,744030,256602,487428,5.3,15.5,603323,197813,405510,4.1,12.6,140707,2.9,25.2,0,15017,15104,97424
1995,18,100740,126812,2362295,2311145,14422,11.5,11140,8.9,366549,126697,239852,5.5,15.9,264248,85301,178947,3.7,11.4,102301,4.5,22.8,0,7490,7522,43487
1995,19,57097,70481,1108770,1086338,7122,10.2,5962,8.5,160490,54375,106115,5,14.8,115626,43338,72288,4,10.6,44864,4.2,21.2,0,4045,4059,20812
1995,20,52006,63151,955917,940378,7112,11.4,5787,9.2,139873,50866,89007,5.4,14.9,108794,37831,70963,4,11.6,31079,3.3,23.2,0,3984,4007,20646
1995,21,62220,76787,1323773,1296623,8909,11.7,7091,9.3,213089,76903,136186,5.9,16.4,158788,58104,100684,4.5,12.2,54301,4.2,24.4,0,4880,4900,30133
1995,22,69816,86523,1386011,1363101,9912,11.6,8178,9.5,243880,93466,150414,6.9,17.9,198060,76292,121768,5.6,14.5,45820,3.4,29,0,5486,5540,38899
1995,23,26167,30688,420990,414733,3646,12,2980,9.8,62563,21243,41320,5.1,15.1,50048,17044,33004,4.1,12.1,12515,3,24.2,0,2010,2015,9920
1995,24,87612,107686,1800097,1762752,13076,12.3,10474,9.8,299445,104957,194488,6,17,224754,81931,142823,4.6,12.8,74691,4.2,25.6,0,6763,6809,40782
1995,25,117390,141833,2688219,2650051,16085,11.5,12878,9.2,406995,135246,271749,5.1,15.4,330659,112220,218439,4.2,12.5,76336,2.9,25,0,8204,8279,54833
1995,26,161096,199288,3654358,3569755,22284,11.3,17149,8.7,597540,210096,387444,5.9,16.7,428334,144992,283342,4.1,12,169206,4.7,24,0,11363,11415,72549
1995,27,90383,109932,2045556,1999258,12156,11.2,9487,8.7,312999,118805,194194,5.9,15.7,220403,74186,146217,3.7,11,92596,4.7,22,0,6068,6108,40151
1995,28,41773,51152,848155,831653,6227,12.3,5015,9.9,144770,58406,86364,7,17.4,111766,40151,71615,4.8,13.4,33004,4,26.8,0,3518,3525,22708
1995,29,101932,124894,2135774,2098938,15006,12.1,12286,9.9,341615,118156,223459,5.6,16.3,267942,93501,174441,4.5,12.8,73673,3.5,25.6,0,8397,8437,47136
1995,30,21493,24898,256194,250389,3317,13.5,2393,9.8,43508,17622,25886,7,17.4,31898,12724,19174,5.1,12.7,11610,4.7,25.4,0,1727,1730,8467
1995,31,35077,42237,657187,642471,4256,10.1,3555,8.5,97579,31771,65808,4.9,15.2,68146,24008,44138,3.7,10.6,29433,4.6,21.2,0,2445,2455,12227
1995,32,26897,31949,662927,640958,5405,17.4,3626,11.7,125532,53865,71667,8.4,19.6,81593,29020,52573,4.5,12.7,43939,6.9,25.4,0,2518,2523,17854
1995,33,25726,30296,459783,448680,3843,12.9,2870,9.6,75817,30385,45432,6.8,16.9,53610,20118,33492,4.5,11.9,22207,5,23.8,0,1901,1907,10675
1995,34,165141,192419,3138546,3100003,23192,12.2,18330,9.6,488210,172419,315791,5.6,15.7,411124,145942,265182,4.7,13.3,77086,2.4,26.6,0,12236,12338,70479
1995,35,29917,35712,490512,479681,4802,13.6,3798,10.8,88253,33996,54257,7.1,18.4,66591,26717,39874,5.6,13.9,21662,4.5,27.8,0,2603,2615,14310
1995,36,350203,409210,6662074,6616828,47664,11.7,41866,10.3,997173,354752,642421,5.4,15.1,906680,293126,613554,4.4,13.7,90493,1.4,27.4,0,29255,29371,160425
1995,37,128770,161947,2944610,2876894,19740,12.4,14259,8.9,457805,161002,296803,5.6,15.9,322372,110097,212275,3.8,11.2,135433,4.7,22.4,0,9687,9717,56778
1995,38,15221,17983,227002,222130,1745,9.8,1409,7.9,34192,10926,23266,4.9,15.4,24449,8829,15620,4,11,9743,4.4,22,0,943,949,4808
1995,39,185483,236995,4488182,4403850,24995,10.6,20059,8.5,669072,226608,442464,5.1,15.2,500408,162545,337863,3.7,11.4,168664,3.8,22.8,0,12872,12973,79237
1995,40,59817,72460,1022458,1008427,8568,11.9,7291,10.1,164093,59557,104536,5.9,16.3,136032,51323,84709,5.1,13.5,28061,2.8,27,0,5174,5191,27134
1995,41,68413,81318,1160949,1132074,11212,14,8514,10.6,207621,77017,130604,6.8,18.3,149870,53724,96146,4.7,13.2,57751,5.1,26.4,0,5654,5716,30651
1995,42,206887,257102,4635464,4570932,25863,10.1,21523,8.4,654518,225485,429033,4.9,14.3,525453,182141,343312,4,11.5,129065,2.8,23,0,14146,14219,91494
1995,44,21548,24250,376781,371131,2669,11.1,2273,9.4,55436,19387,36049,5.2,14.9,44136,14181,29955,3.8,11.9,11300,3,23.8,0,1552,1560,7546
1995,45,62675,78274,1368977,1342742,9858,12.8,7569,9.8,216667,82476,134191,6.1,16.1,164199,60129,104070,4.5,12.2,52468,3.9,24.4,0,5147,5177,30319
1995,46,17171,19969,264483,258190,2127,10.7,1669,8.4,38825,12469,26356,4.8,15,26238,10350,15888,4,10.2,12587,4.8,20.4,0,1163,1164,5405
1995,47,88817,111848,2136762,2071888,13707,12.4,10474,9.5,372529,125622,246907,6.1,18,242781,82241,160540,4,11.7,129748,6.3,23.4,0,7087,7139,43354
1995,48,304034,389147,6593278,6437669,51671,13.4,41292,10.7,1237687,477202,760485,7.4,19.2,926469,337018,589451,5.2,14.4,311218,4.8,28.8,0,27732,28005,180751
1995,49,32474,39149,733341,710460,5943,15.5,4039,10.6,139133,54216,84917,7.6,19.6,93370,33768,59602,4.8,13.1,45763,6.5,26.2,0,2763,2777,20254
1995,50,15904,17980,221819,219517,1927,10.8,1609,9,32625,10775,21850,4.9,14.9,28020,11567,16453,5.3,12.8,4605,2.1,25.6,0,1139,1140,6263
1995,51,113851,144500,2432181,2385108,17546,12.3,13532,9.5,395538,144859,250679,6.1,16.6,301392,107636,193756,4.5,12.6,94146,4,25.2,0,8710,8755,49887
1995,53,109793,131600,1911897,1885068,18020,13.8,14691,11.3,320160,123155,197005,6.5,17,266501,97854,168647,5.2,14.1,53659,2.9,28.2,0,9931,10012,56470
1995,54,30050,36575,517672,507859,4161,11.5,3257,9,82372,29326,53046,5.8,16.2,62745,24236,38509,4.8,12.4,19627,3.8,24.8,0,2163,2166,11015
1995,55,97668,118674,2149536,2111438,12225,10.4,9979,8.5,292374,93956,198418,4.4,13.8,216179,70291,145888,3.3,10.2,76195,3.6,20.4,0,6766,6876,39606
1995,56,12678,14691,152484,150101,1802,12.4,1400,9.6,26335,10259,16076,6.8,17.5,21569,7887,13682,5.3,14.4,4766,3.1,28.8,0,955,956,4198
1996,01,70247,87659,1529613,1517840,10721,12.4,8773,10.1,238477,89766,148711,5.9,15.7,214931,72132,142799,4.8,14.2,23546,1.5,28.4,0,6118,6118,37078
1996,02,12128,14441,177097,175631,1859,13,1522,10.7,30272,9714,20558,5.5,17.2,27340,10869,16471,6.2,15.6,2932,1.6,31.2,0,930,930,4441
1996,04,72373,89522,1560120,1519275,13178,15,9998,11.4,296539,115988,180551,7.6,19.5,214850,79970,134880,5.3,14.1,81689,5.4,28.2,0,6651,6652,43090
1996,05,45282,54317,890862,882467,6695,12.4,5674,10.5,131747,47090,84657,5.3,14.9,114957,37309,77648,4.2,13,16790,1.9,26,0,4006,4007,21723
1996,06,533916,656141,10953369,10867543,83444,12.8,73535,11.3,1937078,684629,1252449,6.3,17.8,1765426,671559,1093867,6.2,16.2,171652,1.6,32.4,0,48254,48266,308558
1996,08,88173,104559,1573399,1548413,15075,14.6,11757,11.4,305723,129590,176133,8.4,19.7,255751,103176,152575,6.7,16.5,49972,3.2,33,0,7651,7652,44769
1996,09,69027,81409,1412202,1403573,8146,10,7614,9.4,204463,81487,122976,5.8,14.6,187205,61224,125981,4.4,13.3,17258,1.3,26.6,0,4852,4853,28897
1996,10,15567,18533,323756,323605,2211,12.1,1854,10.1,48344,18331,30013,5.7,14.9,48041,17100,30941,5.3,14.8,303,0.1,29.6,0,1118,1118,6933
1996,11,14897,17886,388503,397889,1844,10.3,1689,9.5,48713,16730,31983,4.2,12.2,67484,16806,50678,4.2,17,-18771,-4.8,24.4,0,944,944,5785
1996,12,288960,352893,5267564,5192648,49338,14.1,42164,12.1,1024359,423981,600378,8.2,19.7,874527,340929,533598,6.6,16.8,149832,2.9,33.6,0,29226,29228,186712
1996,13,128308,161583,2948479,2903831,22432,14.1,17505,11,535314,209521,325793,7.2,18.4,446017,174934,271083,6,15.4,89297,3,30.8,0,11270,11271,76178
1996,15,21499,27072,421801,422490,2801,10.3,2835,10.5,60931,27470,33461,6.5,14.4,62309,20565,41744,4.9,14.7,-1378,-0.3,28.8,0,1776,1776,9072
1996,16,24803,29029,378847,373127,4159,14.6,3086,10.8,70054,27110,42944,7.3,18.8,58614,21906,36708,5.9,15.7,11440,3.1,31.4,0,2126,2126,12482
1996,17,215915,263187,4931639,4902424,28857,11,25080,9.6,727845,262148,465697,5.3,14.8,669415,206542,462873,4.2,13.7,58430,1.1,27.4,0,15940,15941,93439
1996,18,102077,128389,2381364,2376361,14091,11,12293,9.6,345501,128150,217351,5.4,14.5,335495,117631,217864,5,14.1,10006,0.4,28.2,0,7964,7965,48956
1996,19,57677,71152,1138560,1124169,6862,9.7,6092,8.6,156656,56230,100426,5,13.9,127874,40846,87028,3.6,11.4,28782,2.5,22.8,0,4022,4023,20974
1996,20,52766,64136,987242,972447,7189,11.3,6071,9.5,152017,57232,94785,5.9,15.6,122426,44893,77533,4.6,12.6,29591,3,25.2,0,4163,4163,24401
1996,21,62919,77957,1345354,1335854,8805,11.4,7522,9.7,205739,83980,121759,6.3,15.4,186738,61280,125458,4.6,14,19001,1.4,28,0,5145,5145,31797
1996,22,71286,88202,1427193,1407156,9777,11.2,7860,9,233665,80314,153351,5.7,16.6,193591,62986,130605,4.5,13.8,40074,2.8,27.6,0,5338,5339,33637
1996,23,26748,31348,425388,423512,3807,12.3,3033,9.8,59074,22973,36101,5.4,13.9,55322,18874,36448,4.5,13.1,3752,0.8,26.2,0,2123,2123,10892
1996,24,88572,108677,1804055,1801753,12346,11.4,11091,10.3,283577,108941,174636,6,15.7,278973,96172,182801,5.3,15.5,4604,0.2,31,0,7007,7012,43985
1996,25,119062,143754,2726620,2708174,15313,10.7,13184,9.2,393874,129224,264650,4.8,14.5,356982,135486,221496,5,13.2,36892,1.3,26.4,0,8329,8330,57694
1996,26,164295,203279,3695346,3676047,22098,11,17827,8.9,530278,182944,347334,5,14.4,491679,149146,342533,4.1,13.4,38599,1,26.8,0,11828,11828,76617
1996,27,92887,112583,2090722,2070519,12516,11.3,9804,8.8,300886,109205,191681,5.3,14.5,260480,78954,181526,3.8,12.6,40406,1.9,25.2,0,6267,6269,41788
1996,28,42269,51929,858244,853164,6295,12.2,5359,10.4,134611,56494,78117,6.6,15.8,124450,44819,79631,5.3,14.6,10161,1.2,29.2,0,3705,3705,22072
1996,29,103215,126733,2177649,2158053,14497,11.5,12457,9.9,333614,122184,211430,5.7,15.5,294423,99682,194741,4.6,13.6,39191,1.9,27.2,0,8556,8556,48704
1996,30,22079,25378,261714,258988,3290,13.1,2689,10.7,42418,17483,24935,6.8,16.4,36965,14290,22675,5.5,14.3,5453,2.1,28.6,0,1746,1746,8261
1996,31,35321,42573,682559,671920,4267,10.1,3840,9.1,97564,35437,62127,5.3,14.5,76285,24978,51307,3.7,11.4,21279,3.1,22.8,0,2617,2617,13617
1996,32,27947,33304,704405,683539,5563,17.1,4067,12.5,144594,65304,79290,9.6,21.2,102862,41433,61429,6.1,15,41732,6.2,30,0,2720,2720,20800
1996,33,26469,31128,477868,468910,3888,12.7,2977,9.7,74882,26268,48614,5.6,16,56965,20026,36939,4.3,12.1,17917,3.9,24.2,0,1939,1940,10861
1996,34,167550,194970,3162975,3151479,22753,11.7,19861,10.3,494784,182341,312443,5.8,15.7,471793,163457,308336,5.2,15,22991,0.7,30,0,13287,13290,71341
1996,35,30569,36595,504733,498067,4822,13.3,3798,10.5,88716,34869,53847,7,17.8,75384,27212,48172,5.5,15.1,13332,2.7,30.2,0,2599,2601,15775
1996,36,353159,412331,6685751,6672472,47794,11.6,43931,10.7,986566,373628,612938,5.6,14.8,960008,331690,628318,5,14.4,26558,0.4,28.8,0,30626,30629,175177
1996,37,132391,166207,3000574,2975330,20353,12.4,15587,9.5,452315,171783,280532,5.8,15.2,401827,134547,267280,4.5,13.5,50488,1.7,27,0,10141,10141,62086
1996,38,15398,18162,232278,230009,1714,9.5,1511,8.4,34540,13684,20856,5.9,15,30001,9598,20403,4.2,13,4539,2,26,0,998,998,4929
1996,39,187279,239476,4577439,4536693,24297,10.2,21523,9,669550,241266,428284,5.3,14.8,588058,187870,400188,4.1,13,81492,1.8,26,0,13662,13665,83410
1996,40,60598,73469,1059747,1041769,8700,11.9,7551,10.4,176961,73473,103488,7.1,17,141005,52203,88802,5,13.5,35956,3.5,27,0,5280,5283,28641
1996,41,70104,83597,1217015,1189725,11229,13.6,8675,10.5,214835,79393,135442,6.7,18.1,160255,56339,103916,4.7,13.5,54580,4.6,27,0,5877,5879,32452
1996,42,207805,258795,4683276,4664500,24959,9.7,22908,8.9,633359,233472,399887,5,13.6,595808,205616,390192,4.4,12.8,37551,0.8,25.6,0,15088,15090,98212
1996,44,21725,24464,377994,377494,2687,11,2426,10,50863,19028,31835,5,13.5,49862,18446,31416,4.9,13.2,1001,0.3,26.4,0,1662,1664,9645
1996,45,64103,80130,1398027,1383948,10219,12.9,8056,10.2,216613,87719,128894,6.3,15.7,188455,62619,125836,4.5,13.6,28158,2.1,27.2,0,5429,5429,32535
1996,46,17448,20283,268662,266747,2219,11,1888,9.4,37456,15242,22214,5.7,14,33625,12311,21314,4.6,12.6,3831,1.4,25.2,0,1289,1289,6352
1996,47,90434,114345,2148462,2143582,14090,12.5,11358,10,329491,133125,196366,6.2,15.4,319730,122873,196857,5.7,14.9,9761,0.5,29.8,0,7659,7663,69872
1996,48,310610,397019,6823845,6713351,52207,13.3,43281,11,1252211,499314,752897,7.4,18.7,1031223,377531,653692,5.6,15.4,220988,3.3,30.8,0,28625,28628,186478
1996,49,34162,41069,770418,751213,6375,15.9,4355,10.9,139950,58049,81901,7.7,18.6,101539,35220,66319,4.7,13.5,38411,5.1,27,0,2992,2993,19996
1996,50,16040,18169,222844,222244,1953,10.8,1698,9.4,32538,12615,19923,5.7,14.6,31338,14947,16391,6.7,14.1,1200,0.5,28.2,0,1214,1214,6718
1996,51,115604,146732,2465732,2449973,17268,11.9,14830,10.2,386493,145866,240627,6,15.8,354975,119459,235516,4.9,14.5,31518,1.3,29,0,9331,9331,50222
1996,53,112031,134360,1948262,1931829,18622,14,15532,11.7,317948,125297,192651,6.5,16.5,285082,97789,187293,5.1,14.8,32866,1.7,29.6,0,10195,10198,55214
1996,54,30217,36895,519637,519318,3968,10.8,3532,9.6,76693,31649,45044,6.1,14.8,76054,24925,51129,4.8,14.6,639,0.2,29.2,0,2367,2367,11766
1996,55,98939,120286,2184472,2168526,12227,10.2,10486,8.8,278346,96140,182206,4.4,12.8,246453,79881,166572,3.7,11.4,31893,1.4,22.8,0,6943,6949,38286
1996,56,13002,15027,150823,151556,1891,12.7,1511,10.2,23438,9267,14171,6.1,15.5,24903,7658,17245,5.1,16.4,-1465,-0.9,31,0,1015,1015,4342
1997,01,71119,89421,1544154,1537043,11391,12.8,9689,10.9,261430,99693,161737,6.5,17,247208,88397,158811,5.8,16.1,14222,0.9,32.2,0,6363,6363,41788
1997,02,12384,14784,182122,179388,1988,13.6,1610,11,36540,12230,24310,6.8,20.4,31071,9703,21368,5.4,17.3,5469,3.1,34.6,0,970,970,4416
1997,04,74812,93249,1654717,1608847,14962,16.3,11406,12.5,370663,151056,219607,9.4,23,278924,118379,160545,7.4,17.3,91739,5.7,34.6,0,7065,7065,47498
1997,05,45623,55154,906694,896806,7014,12.8,6040,11,148425,55590,92835,6.2,16.6,128650,44221,84429,4.9,14.3,19775,2.3,28.6,0,4092,4092,22299
1997,06,541289,665108,11332883,11151803,90208,13.6,81035,12.3,2274112,822432,1451680,7.4,20.4,1911953,753272,1158681,6.8,17.1,362159,3.3,34.2,0,48557,48558,342815
1997,08,90837,108371,1630245,1601950,16708,15.7,12753,12,336499,142429,194070,8.9,21,279908,113297,166611,7.1,17.5,56591,3.5,35,0,7956,7956,50503
1997,09,69113,81941,1466891,1445493,8854,10.8,8331,10.2,246873,82514,164359,5.7,17.1,204076,76401,127675,5.3,14.1,42797,3,28.2,0,5019,5019,32797
1997,10,15973,19154,338020,330868,2598,13.8,2020,10.7,62268,24659,37609,7.5,18.8,47964,18795,29169,5.7,14.5,14304,4.3,29,0,1159,1159,7407
1997,11,14857,17806,389857,389370,1933,10.8,2035,11.4,56831,18692,38139,4.8,14.6,55856,21910,33946,5.6,14.3,975,0.3,28.6,0,1014,1014,6393
1997,12,292387,359980,5414423,5343300,53317,14.9,46047,12.9,1122453,468512,653941,8.8,21,980208,405105,575103,7.6,18.3,142245,2.7,36.6,0,30462,30463,199698
1997,13,131028,166115,3019603,2983982,23700,14.4,19063,11.6,585317,228088,357229,7.6,19.6,514075,199995,314080,6.7,17.2,71242,2.4,34.4,0,11964,11964,97130
1997,15,21466,27009,421133,421474,2915,10.8,2937,10.9,60451,20657,39794,4.9,14.3,61133,20405,40728,4.8,14.5,-682,-0.2,28.6,0,1762,1762,9598
1997,16,25575,30023,388360,383919,4554,15.4,3562,12,73581,29531,44050,7.7,19.2,64699,26317,38382,6.9,16.9,8882,2.3,33.8,0,2260,2260,11277
1997,17,217733,266291,5022294,4978069,30750,11.6,27510,10.4,808608,283940,524668,5.7,16.2,720158,261677,458481,5.3,14.5,88450,1.7,29,0,16572,16572,112741
1997,18,102793,130432,2432529,2408409,15338,11.8,13301,10.3,389829,135231,254598,5.6,16.2,341589,127676,213913,5.3,14.2,48240,2,28.4,0,8274,8274,54427
1997,19,57954,71920,1152760,1146531,7461,10.4,6709,9.4,172912,59467,113445,5.2,15.1,160456,57950,102506,5.1,14,12456,1.1,28,0,4155,4155,26799
1997,20,53327,65272,1023336,1005385,7971,12.3,6794,10.5,174529,68479,106050,6.8,17.4,138626,49444,89182,4.9,13.8,35903,3.6,27.6,0,4203,4203,24367
1997,21,63608,79348,1386671,1366187,9655,12.3,8237,10.5,237917,85042,152875,6.2,17.4,196948,72772,124176,5.3,14.4,40969,3,28.8,0,5161,5161,32270
1997,22,72192,89720,1461249,1445436,10564,11.9,9124,10.2,263696,93628,170068,6.5,18.2,232069,88544,143525,6.1,16.1,31627,2.1,32.2,0,5749,5749,36611
1997,23,27204,32013,435273,430596,3947,12.4,3290,10.4,67146,23415,43731,5.4,15.6,57792,22538,35254,5.2,13.4,9354,2.2,26.8,0,2075,2075,11602
1997,24,89546,110313,1869821,1837782,13880,12.7,12344,11.3,351998,132636,219362,7.2,19.2,287919,107704,180215,5.9,15.7,64079,3.5,31.4,0,7307,7307,43634
1997,25,121311,147093,2805737,2767461,16984,11.7,13728,9.4,465228,168258,296970,6.1,16.8,388676,136230,252446,4.9,14,76552,2.8,28,0,8285,8285,59442
1997,26,166302,205977,3788119,3743274,23454,11.5,20710,10.1,639530,217907,421623,5.8,17.1,549840,192929,356911,5.2,14.7,89690,2.4,29.4,0,12533,12533,80058
1997,27,94571,115237,2143862,2119083,13881,12.2,11250,9.9,344773,119717,225056,5.6,16.3,295214,114073,181141,5.4,13.9,49559,2.4,27.8,0,6750,6750,47812
1997,28,42810,52944,882831,871930,6596,12.6,5618,10.7,151278,53339,97939,6.1,17.3,129477,43883,85594,5,14.8,21801,2.5,29.6,0,3723,3723,20389
1997,29,103505,127642,2241057,2210438,15038,11.8,14111,11.1,372029,127305,244724,5.8,16.8,310792,114486,196306,5.2,14.1,61237,2.7,28.2,0,9120,9120,55995
1997,30,22631,26050,266218,264252,3473,13.5,2783,10.8,47415,18308,29107,6.9,17.9,43482,16603,26879,6.3,16.5,3933,1.4,33,0,1848,1848,9171
1997,31,35809,43191,689352,686399,4730,11,4103,9.6,106778,41841,64937,6.1,15.6,100871,32761,68110,4.8,14.7,5907,0.9,29.4,0,2551,2551,16260
1997,32,29497,35507,750512,727932,6636,19.2,4488,13,158020,68348,89672,9.4,21.7,112859,39432,73427,5.4,15.5,45161,6.2,31,0,2816,2816,18118
1997,33,26990,31813,489415,483945,3979,12.6,3306,10.5,80080,28118,51962,5.8,16.5,69139,25217,43922,5.2,14.3,10941,2.2,28.6,0,2070,2070,11713
1997,34,170254,198247,3258591,3211284,25247,12.8,21738,11,602262,212380,389882,6.6,18.8,507649,200003,307646,6.2,15.8,94613,3,31.6,0,13559,13559,80352
1997,35,30759,37189,512787,509114,5071,13.7,4446,12,95034,37901,57133,7.4,18.7,87688,30249,57439,5.9,17.2,7346,1.5,34.4,0,2831,2831,14972
1997,36,356925,417265,6802381,6749099,51095,12.3,46098,11.1,1130473,387219,743254,5.7,16.7,1023909,393546,630363,5.8,15.2,106564,1.5,30.4,0,30732,30732,177608
1997,37,136584,173190,3100807,3052055,24068,14.2,17075,10,523890,203133,320757,6.7,17.2,426386,156270,270116,5.1,14,97504,3.2,28,0,10575,10575,66103
1997,38,15261,18067,242658,237454,1770,9.8,1840,10.2,42709,13866,28843,5.8,18,32301,13579,18722,5.7,13.6,10408,4.4,27.2,0,1160,1160,7735
1997,39,188525,242011,4653770,4616927,26985,11.2,24451,10.1,752692,284352,468340,6.2,16.3,679007,238589,440418,5.2,14.7,73685,1.6,29.4,0,14410,14410,95574
1997,40,61285,74941,1095813,1077618,9811,13.2,8300,11.2,204126,79651,124475,7.4,18.9,167735,59688,108047,5.5,15.6,36391,3.3,31.2,0,5432,5432,33877
1997,41,71390,85533,1274898,1246464,11683,13.8,9680,11.4,246487,88290,158197,7.1,19.8,189619,71819,117800,5.8,15.2,56868,4.6,30.4,0,6118,6118,33245
1997,42,209371,262288,4768827,4730865,28280,10.8,24940,9.6,741428,257317,484111,5.4,15.7,665505,247271,418234,5.2,14.1,75923,1.6,28.2,0,15063,15063,110568
1997,44,21985,24753,388629,383505,2736,11.1,2452,10,60731,22004,38727,5.7,15.8,50483,17910,32573,4.7,13.2,10248,2.6,26.4,0,1663,1663,8942
1997,45,65651,82583,1437253,1418402,11173,13.7,8773,10.8,247057,97943,149114,6.9,17.4,209355,77787,131568,5.5,14.8,37702,2.6,29.6,0,5520,5520,36310
1997,46,17561,20549,276129,272405,2438,11.9,2123,10.4,44910,18240,26670,6.7,16.5,37462,14291,23171,5.2,13.8,7448,2.7,27.6,0,1352,1352,6873
1997,47,91591,116886,2207269,2179189,15087,13,12678,10.9,389303,149410,239893,6.9,17.9,333142,116904,216238,5.4,15.3,56161,2.6,30.6,0,8032,8032,54704
1997,48,314689,405103,7097037,6966375,55983,13.9,47888,11.9,1450743,568149,882594,8.2,20.8,1189419,469026,720393,6.7,17.1,261324,3.7,34.2,0,29979,29979,220929
1997,49,35629,43022,813763,793332,6948,16.5,4980,11.8,166847,70363,96484,8.9,21,125985,53433,72552,6.7,15.9,40862,5.1,31.8,0,3170,3170,22166
1997,50,16269,18497,229132,226081,2117,11.5,1805,9.8,36180,16081,20099,7.1,16,30077,11549,18528,5.1,13.3,6103,2.7,26.6,0,1216,1216,5982
1997,51,118049,150435,2577712,2522571,19450,13.1,15724,10.6,476494,177066,299428,7,18.9,366213,134175,232038,5.3,14.5,110281,4.4,29,0,9262,9262,55667
1997,53,113960,137179,1999705,1975920,19859,14.6,16914,12.4,395615,149567,246048,7.6,20,348046,154617,193429,7.8,17.6,47569,2.4,35.2,0,10332,10333,59617
1997,54,30407,37396,530054,524833,4245,11.4,3731,10,85098,31147,53951,5.9,16.2,74657,24040,50617,4.6,14.2,10441,2,28.4,0,2378,2378,12760
1997,55,100150,122451,2233896,2210322,13451,11.1,11304,9.3,328673,119807,208866,5.4,14.9,281524,97464,184060,4.4,12.7,47149,2.2,25.4,0,7013,7013,40403
1997,56,13159,15076,153389,151861,1920,12.7,1809,12,28880,10729,18151,7.1,19,25823,10058,15765,6.6,17,3057,2,34,0,1049,1049,4954
1998,01,71184,89772,1564264,1554924,10431,11.6,9870,11,247791,89511,158280,5.8,15.9,229111,93003,136108,6,14.7,18680,1.2,29.4,0,6666,6666,38934
1998,02,12574,15009,190351,186202,1987,13.3,1675,11.2,36366,13872,22494,7.4,19.5,28068,9436,18632,5.1,15.1,8298,4.4,30.2,0,1032,1032,4616
1998,04,75861,94828,1726839,1690810,13306,14.2,11412,12.1,343356,132954,210402,7.9,20.3,271299,113520,157779,6.7,16,72057,4.3,32,0,7528,7528,65412
1998,05,45392,55295,933508,922751,6505,11.8,6327,11.5,147810,59576,88234,6.5,16,126295,51145,75150,5.5,13.7,21515,2.3,27.4,0,4400,4400,23580
1998,06,547613,673732,11812947,11551112,87132,13,76362,11.4,2258893,830664,1428229,7.2,19.6,1735222,677762,1057460,5.9,15,523671,4.6,30,0,49757,49757,331103
1998,08,92986,111498,1720424,1675464,16134,14.7,12711,11.6,339436,133185,206251,7.9,20.3,249515,95993,153522,5.7,14.9,89921,5.4,29.8,0,8438,8438,48996
1998,09,69005,81916,1483816,1474336,8390,10.2,8255,10.1,229677,88146,141531,6,15.6,210716,72500,138216,4.9,14.3,18961,1.3,28.6,0,5284,5284,32961
1998,10,16294,19518,347160,342454,2476,12.8,2064,10.7,61666,25315,36351,7.4,18,52254,17460,34794,5.1,15.3,9412,2.7,30.6,0,1244,1244,8032
1998,11,14773,17793,399579,395209,1789,10.1,1752,9.8,58206,18996,39210,4.8,14.7,49465,15691,33774,4,12.5,8741,2.2,25,0,968,968,6749
1998,12,294299,362462,5629072,5517662,49783,13.8,46200,12.8,1113644,425701,687943,7.7,20.2,890823,375164,515659,6.8,16.1,222821,4.1,32.2,0,30924,30924,193097
1998,13,133252,169415,3114491,3068552,23294,13.9,19507,11.6,577911,228036,349875,7.4,18.8,486032,194306,291726,6.3,15.8,91879,3,31.6,0,12413,12413,86293
1998,15,21380,26808,415463,418240,2692,10,2864,10.6,58037,23996,34041,5.7,13.9,63591,24639,38952,5.9,15.2,-5554,-1.3,27.8,0,1795,1795,9526
1998,16,26008,30632,409440,398919,4217,13.9,3537,11.7,79501,34475,45026,8.6,19.9,58458,20750,37708,5.2,14.7,21043,5.2,29.4,0,2376,2376,11790
1998,17,219245,269011,5159503,5089815,28657,10.7,25421,9.5,803055,269736,533319,5.3,15.8,663679,227499,436180,4.5,13,139376,2.8,26,0,16454,16454,110528
1998,18,103255,131429,2492716,2462442,13798,10.5,12574,9.6,371745,136428,235317,5.5,15.1,311198,110912,200286,4.5,12.6,60547,2.5,25.2,0,8262,8262,51150
1998,19,58097,72351,1191965,1171738,6936,9.6,6340,8.8,170505,55767,114738,4.8,14.6,130051,43844,86207,3.7,11.1,40454,3.5,22.2,0,4134,4134,22128
1998,20,53594,65851,1057420,1040239,7349,11.2,6598,10.1,174983,65754,109229,6.3,16.8,140621,56748,83873,5.5,13.5,34362,3.3,27,0,4382,4382,26275
1998,21,64136,80353,1417791,1401123,9195,11.5,8019,10,227380,91628,135752,6.5,16.2,194043,66440,127603,4.7,13.8,33337,2.4,27.6,0,5302,5302,31200
1998,22,72602,90443,1511085,1486718,10014,11.1,9012,10,266032,95349,170683,6.4,17.9,217298,81380,135918,5.5,14.6,48734,3.3,29.2,0,5922,5922,42913
1998,23,27757,32679,449965,442486,3939,12.2,3180,9.8,67163,25821,41342,5.8,15.2,52204,20213,31991,4.6,11.8,14959,3.4,23.6,0,2176,2176,11816
1998,24,89974,110917,1922137,1899176,12765,11.5,11921,10.8,326154,126236,199918,6.6,17.2,280232,109612,170620,5.8,14.8,45922,2.4,29.6,0,7393,7393,50711
1998,25,122544,148564,2868378,2835988,15650,10.6,13772,9.3,449904,150811,299093,5.3,15.9,385123,127174,257949,4.5,13.6,64781,2.3,27.2,0,8862,8862,58658
1998,26,166559,206886,3875781,3828325,21766,10.5,20270,9.8,598413,213553,384860,5.6,15.6,503501,173595,329906,4.5,13.2,94912,2.4,26.4,0,13239,13239,85747
1998,27,96430,117421,2236123,2188697,12907,11.1,10414,9,364601,121108,243493,5.5,16.7,269749,90982,178767,4.2,12.3,94852,4.4,24.6,0,6719,6719,47498
1998,28,42886,53305,904673,892900,6171,11.6,5662,10.7,138442,49299,89143,5.5,15.5,114896,43591,71305,4.9,12.9,23546,2.6,25.8,0,3917,3917,23430
1998,29,103817,128458,2271469,2254889,14381,11.2,13298,10.4,336238,130708,205530,5.8,14.9,303077,100323,202754,4.4,13.4,33161,1.5,26.8,0,8883,8883,49293
1998,30,23024,26521,272096,268743,3486,13.3,2913,11.1,46977,19901,27076,7.4,17.5,40271,16851,23420,6.3,15,6706,2.5,30,0,2008,2008,8423
1998,31,35905,43466,704888,696092,4414,10.2,4016,9.3,102710,37276,65434,5.4,14.8,85117,31147,53970,4.5,12.2,17593,2.6,24.4,0,2686,2686,14163
1998,32,30787,37285,779911,764278,6385,17.5,4489,12.3,143070,61515,81555,8,18.7,111804,37410,74394,4.9,14.6,31266,4.1,29.2,0,3007,3007,19472
1998,33,27495,32267,507336,498116,3713,11.6,3157,9.9,82381,27523,54858,5.5,16.5,63940,24717,39223,5,12.8,18441,3.7,25.6,0,2052,2052,13096
1998,34,172256,200653,3332104,3295447,23810,11.9,20852,10.5,573138,210852,362286,6.4,17.4,499825,184852,314973,5.6,15.2,73313,2.2,30.4,0,13932,13932,81505
1998,35,30913,37432,521364,515866,4630,12.4,4259,11.4,92981,40376,52605,7.8,18,81985,33167,48818,6.4,15.9,10996,2.1,31.8,0,2760,2760,16871
1998,36,360277,421540,6952280,6874662,48687,11.6,43666,10.4,1158305,393513,764792,5.7,16.8,1003069,347613,655456,5.1,14.6,155236,2.2,29.2,0,30537,30537,173389
1998,37,139048,175959,3186363,3142561,22052,12.6,18873,10.8,512815,203990,308825,6.5,16.3,425211,169489,255722,5.4,13.5,87604,2.8,27,0,11661,11664,69864
1998,38,15285,18087,243987,243173,1729,9.6,1672,9.2,37850,13698,24152,5.6,15.6,36222,12838,23384,5.3,14.9,1628,0.7,29.8,0,1089,1089,6932
1998,39,189006,243121,4751372,4700175,24019,9.9,22509,9.3,719756,237168,482588,5,15.3,617362,225602,391760,4.8,13.1,102394,2.2,26.2,0,14180,14181,96181
1998,40,61526,75425,1138885,1116702,8838,11.8,8140,10.8,196809,72780,124029,6.5,17.6,152443,61562,90881,5.5,13.7,44366,3.9,27.4,0,5493,5495,31861
1998,41,72173,86408,1291739,1282318,10813,12.6,9636,11.2,215518,81653,133865,6.4,16.8,196676,73423,123253,5.7,15.3,18842,1.5,30.6,0,6227,6227,36199
1998,42,210232,263993,4857655,4813369,25903,9.8,23701,9,703546,243869,459677,5.1,14.6,614975,215323,399652,4.5,12.8,88571,1.8,25.6,0,15122,15122,96346
1998,44,22163,24910,400175,394558,2612,10.5,2413,9.7,60139,21656,38483,5.5,15.2,48905,16013,32892,4.1,12.4,11234,2.8,24.8,0,1647,1647,8192
1998,45,66821,84107,1492775,1464809,10586,12.7,8908,10.7,257359,105149,152210,7.2,17.6,201427,79927,121500,5.5,13.8,55932,3.8,27.6,0,5845,5845,34496
1998,46,17648,20654,285759,280509,2257,11,2068,10,43303,14737,28566,5.3,15.4,32802,12779,20023,4.6,11.7,10501,3.7,23.4,0,1418,1418,7088
1998,47,91610,117770,2273505,2239565,13943,11.9,12658,10.8,372206,146707,225499,6.6,16.6,304325,111233,193092,5,13.6,67881,3,27.2,0,8397,8398,54404
1998,48,317825,410599,7397084,7246952,52894,13,46290,11.4,1430863,546107,884756,7.5,19.7,1130598,428169,702429,5.9,15.6,300265,4.1,31.2,0,29933,29937,216355
1998,49,36535,44197,837059,824763,6550,15,5175,11.9,161517,67591,93926,8.2,19.6,136924,44982,91942,5.5,16.6,24593,3,33.2,0,3433,3433,23593
1998,50,16311,18481,236908,233354,1914,10.4,1887,10.2,34971,11993,22978,5.1,15,27864,10672,17192,4.6,11.9,7107,3.1,23.8,0,1284,1284,5674
1998,51,119595,152958,2642901,2610099,18526,12.2,15638,10.3,434666,168817,265849,6.5,16.7,369063,140033,229030,5.4,14.1,65603,2.6,28.2,0,9646,9646,59450
1998,53,115841,139701,2071927,2034268,18713,13.5,15809,11.4,368449,131928,236521,6.5,18.1,293130,108103,185027,5.3,14.4,75319,3.7,28.8,0,10440,10440,55971
1998,54,30398,37532,537355,534253,3779,10.1,3571,9.5,80569,30728,49841,5.8,15.1,74366,24515,49851,4.6,13.9,6203,1.2,27.8,0,2407,2407,12495
1998,55,100895,123469,2292685,2263122,12185,9.9,10871,8.8,319889,109426,210463,4.8,14.1,260765,88281,172484,3.9,11.5,59124,2.6,23,0,7171,7171,42406
1998,56,13389,15391,156654,155229,1931,12.7,1615,10.6,28517,12203,16314,7.9,18.4,25667,10787,14880,6.9,16.5,2850,1.9,33,0,1073,1073,5824
1999,01,71205,90344,1606748,1592218,10252,11.4,9540,10.6,259416,107222,152194,6.7,16.3,230355,84307,146048,5.3,14.5,29061,1.8,29,0,6393,6393,39765
1999,02,12622,15134,192718,192105,1780,11.8,1616,10.7,30296,10726,19570,5.6,15.8,29069,9269,19800,4.8,15.1,1227,0.7,30.2,0,1026,1026,4472
1999,04,77311,97254,1802377,1764631,14051,14.6,11555,12,359456,149166,210290,8.5,20.4,283964,114089,169875,6.5,16.1,75492,4.3,32.2,0,7293,7293,56325
1999,05,45341,55562,949164,942752,6495,11.7,6159,11.1,146196,53021,93175,5.6,15.5,133372,52463,80909,5.6,14.1,12824,1.4,28.2,0,4172,4172,23722
1999,06,554863,683714,12136894,11990313,87519,12.9,76825,11.3,2235094,847713,1387381,7.1,18.6,1941931,756156,1185775,6.3,16.2,293163,2.4,32.4,0,48337,48337,340217
1999,08,95003,114449,1792827,1759199,16109,14.3,12971,11.5,348583,143998,204585,8.2,19.8,281326,115974,165352,6.6,16,67257,3.8,32,0,8335,8335,50944
1999,09,68663,82063,1515987,1499805,8038,9.8,7811,9.5,228682,80295,148387,5.4,15.2,196317,73256,123061,4.9,13.1,32365,2.1,26.2,0,5050,5050,30806
1999,10,16662,19938,349227,348206,2489,12.6,2050,10.4,54357,22718,31639,6.5,15.6,52315,18584,33731,5.3,15,2042,0.6,30,0,1182,1182,7526
1999,11,14733,17835,406721,403311,1800,10.1,1756,9.9,59547,21680,37867,5.4,14.8,52727,20106,32621,5,13.1,6820,1.7,26.2,0,933,933,6353
1999,12,296539,367234,5853575,5742642,51234,14,45649,12.5,1207694,436562,771132,7.6,21,985828,429447,556381,7.5,17.2,221866,3.8,34.4,0,30396,30396,193480
1999,13,135585,172753,3297069,3214638,22852,13.4,19306,11.3,633761,249748,384013,7.8,19.7,468899,189420,279479,5.9,14.6,164862,5.1,29.2,0,12198,12198,82646
1999,15,21205,26591,415315,415078,2545,9.5,2696,10.1,59248,25382,33866,6.1,14.3,58773,21172,37601,5.1,14.2,475,0.1,28.4,0,1695,1695,10249
1999,16,26590,31613,429130,422144,4363,14,3346,10.7,73334,30248,43086,7.2,17.4,59362,24069,35293,5.7,14.1,13972,3.3,28.2,0,2254,2254,12893
1999,17,219961,271020,5268971,5212988,27980,10.4,25848,9.6,788242,275854,512388,5.3,15.1,676278,238450,437828,4.6,13,111964,2.1,26,0,16158,16158,98406
1999,18,103095,132072,2555728,2532484,13249,10.1,12534,9.5,369603,126738,242865,5,14.6,323116,110027,213089,4.3,12.8,46487,1.8,25.6,0,8237,8237,54103
1999,19,57954,72615,1227752,1214396,6713,9.3,6387,8.8,173114,63199,109915,5.2,14.3,146402,49929,96473,4.1,12.1,26712,2.2,24.2,0,4219,4219,22359
1999,20,53670,66226,1094892,1079168,7020,10.6,6652,10.1,178210,67247,110963,6.2,16.5,146761,59854,86907,5.5,13.6,31449,2.9,27.2,0,4280,4280,26864
1999,21,64218,80979,1438085,1429750,8762,10.9,8051,10,216410,85017,131393,5.9,15.1,199740,69004,130736,4.8,14,16670,1.1,28,0,5350,5350,31284
1999,22,72517,90939,1548177,1544149,9509,10.5,9032,10,245139,88905,156234,5.8,15.9,237083,90099,146984,5.8,15.4,8056,0.5,30.8,0,5897,5897,45762
1999,23,28318,33386,464963,458062,3879,11.7,3154,9.5,70655,25691,44964,5.6,15.4,56853,19499,37354,4.3,12.4,13802,3,24.8,0,2080,2080,11386
1999,24,90551,111811,1951317,1937473,12499,11.2,11412,10.2,329778,125198,204580,6.5,17,302090,122557,179533,6.3,15.6,27688,1.4,31.2,0,6943,6943,56037
1999,25,123189,149587,2940266,2905949,15144,10.2,13970,9.4,468929,168681,300248,5.8,16.1,400295,141714,258581,4.9,13.8,68634,2.3,27.6,0,8808,8808,60529
1999,26,166542,208019,3944085,3915129,21016,10.1,19718,9.5,607724,226804,380920,5.8,15.5,549812,184135,365677,4.7,14,57912,1.5,28,0,12782,12782,88597
1999,27,97772,119533,2312338,2280605,12920,10.9,10751,9.1,350549,134263,216286,5.9,15.4,287082,106373,180709,4.7,12.6,63467,2.8,25.2,0,6612,6612,42182
1999,28,42998,53712,939801,931169,6159,11.5,5731,10.7,145202,51988,93214,5.6,15.6,127938,49117,78821,5.3,13.7,17264,1.9,27.4,0,3933,3933,23661
1999,29,103901,129299,2329025,2303360,14192,11,13269,10.3,359548,132178,227370,5.7,15.6,308217,114111,194106,5,13.4,51331,2.2,26.8,0,8803,8803,46197
1999,30,23241,26848,283401,277953,3208,12,2825,10.6,48584,18611,29973,6.7,17.5,37687,14891,22796,5.4,13.6,10897,3.9,27.2,0,1916,1916,8314
1999,31,36010,43713,728879,718369,4205,9.6,3961,9.1,112531,43096,69435,6,15.7,91511,36320,55191,5.1,12.7,21020,3,25.4,0,2582,2582,19709
1999,32,32240,39498,841721,813262,6935,18.1,4704,12.3,173302,76118,97184,9.4,21.3,116383,42907,73476,5.3,14.3,56919,7,28.6,0,3081,3081,22686
1999,33,27757,32782,521176,514173,3544,10.9,3005,9.2,74334,27158,47176,5.3,14.5,60328,19646,40682,3.8,11.7,14006,2.8,23.4,0,2016,2016,10729
1999,34,172977,202065,3407641,3369725,22557,11.2,20848,10.4,559412,213169,346243,6.3,16.6,483580,171103,312477,5.1,14.4,75832,2.2,28.8,0,13880,13880,81840
1999,35,30830,37743,535123,532112,4622,12.3,4290,11.4,89800,38186,51614,7.2,16.9,83777,29712,54065,5.6,15.7,6023,1.2,31.4,0,2794,2794,15035
1999,36,361153,424942,7071071,7013892,47236,11.2,43322,10.2,1083187,400354,682833,5.7,15.4,968829,356672,612157,5.1,13.8,114358,1.6,27.6,0,30114,30114,179703
1999,37,141395,179380,3281177,3238145,21750,12.2,18065,10.2,553638,214293,339345,6.6,17.1,467575,179076,288499,5.5,14.4,86063,2.7,28.8,0,11522,11522,81747
1999,38,15225,18087,247019,246400,1530,8.5,1526,8.4,32744,12767,19977,5.2,13.3,31505,10582,20923,4.3,12.8,1239,0.5,25.6,0,1008,1008,5066
1999,39,188850,244231,4812029,4785467,23293,9.6,21883,9,690742,245007,445735,5.1,14.4,637617,221287,416330,4.6,13.3,53125,1.1,26.6,0,13713,13713,88451
1999,40,61424,75635,1154895,1150040,8733,11.6,8302,11,194309,75665,118644,6.6,16.9,184599,70195,114404,6.1,16.1,9710,0.8,32.2,0,5431,5431,32643
1999,41,72476,87338,1309931,1300624,10709,12.3,9631,11.1,215294,81491,133803,6.3,16.6,196679,78952,117727,6.1,15.1,18615,1.5,30.2,0,6323,6323,35739
1999,42,210279,264930,4909682,4884235,25039,9.5,23901,9,688506,242211,446295,5,14.1,637612,217038,420574,4.4,13.1,50894,1,26.2,0,15129,15129,97338
1999,44,22068,24983,402703,401157,2521,10.1,2423,9.7,55953,18030,37923,4.5,13.9,52861,18180,34681,4.5,13.2,3092,0.7,26.4,0,1724,1724,8506
1999,45,68153,85886,1539564,1519624,10757,12.7,8885,10.5,248517,95047,153470,6.3,16.4,208637,70839,137798,4.7,13.7,39880,2.7,27.4,0,5701,5701,34117
1999,46,17726,20844,291502,288703,2208,10.6,2010,9.7,40913,16727,24186,5.8,14.2,35314,13015,22299,4.5,12.2,5599,2,24.4,0,1362,1362,6365
1999,47,91282,118281,2307653,2294827,13494,11.4,12875,10.9,369103,144145,224958,6.3,16.1,343450,130765,212685,5.7,15,25653,1.1,30,0,8258,8258,51251
1999,48,318388,415081,7618480,7534968,52078,12.6,47181,11.4,1440316,560733,879583,7.4,19.1,1273293,508298,764995,6.7,16.9,167023,2.2,33.8,0,30473,30473,223962
1999,49,37559,45911,874548,863060,7080,15.7,5307,11.8,155055,64845,90210,7.5,18,132079,52965,79114,6.1,15.3,22976,2.7,30.6,0,3525,3525,28090
1999,50,16411,18748,243894,240470,1904,10.2,1638,8.8,34150,12401,21749,5.2,14.2,27302,9687,17615,4,11.4,6848,2.8,22.8,0,1154,1154,6686
1999,51,120352,154389,2738808,2698619,17561,11.4,15931,10.4,449235,166222,283013,6.2,16.6,368858,134828,234030,5,13.7,80377,2.9,27.4,0,9631,9631,55953
1999,53,116654,141204,2142693,2110334,18314,13,16507,11.8,378986,152182,226804,7.2,18,314268,119158,195110,5.6,14.9,64718,3.1,29.8,0,10666,10666,61026
1999,54,30313,37514,536618,537918,3732,9.9,3739,10,72794,28146,44648,5.2,13.5,75394,26922,48472,5,14,-2600,-0.5,27,0,2414,2414,12191
1999,55,101193,124456,2333239,2312929,11985,9.7,10896,8.8,316063,104737,211326,4.5,13.7,275444,93640,181804,4,11.9,40619,1.8,23.8,0,7139,7139,43716
1999,56,13373,15481,165212,162778,1839,11.9,1733,11.2,29816,10837,18979,6.7,18.3,24947,9887,15060,6.1,15.3,4869,3,30.6,0,1162,1162,5243
2000,01,70588,90084,1642439,1624678,9581,10.6,9904,11,259781,85796,173985,5.3,16,224258,85137,139121,5.2,13.8,35523,2.2,27.6,0,6308,6308,37525
2000,02,12622,15150,202331,197752,1846,12.2,1848,12.2,40677,16014,24663,8.1,20.6,31519,14195,17324,7.2,15.9,9158,4.7,31.8,0,1011,1011,5382
2000,04,77985,98974,1891324,1847766,13712,14,11979,12.2,382772,155321,227451,8.4,20.7,295657,110757,184900,6,16,87115,4.7,32,0,7340,7340,48971
2000,05,44950,55464,986354,966824,6155,11.1,6262,11.3,156984,55759,101225,5.8,16.2,117923,44730,73193,4.6,12.2,39061,4,24.4,0,3935,3935,21571
2000,06,561944,693690,12626477,12366627,87448,12.7,77832,11.3,2439228,894539,1544689,7.2,19.7,1919529,774376,1145153,6.3,15.5,519699,4.2,31,0,47652,47652,340240
2000,08,96551,116723,1880099,1837443,15957,13.8,13664,11.8,361362,140127,221235,7.6,19.7,276049,108068,167981,5.9,15,85313,4.7,30,0,8226,8226,49185
2000,09,68709,82209,1535090,1526209,7922,9.6,7851,9.6,223188,77789,145399,5.1,14.6,205426,73822,131604,4.8,13.5,17762,1.1,27,0,4762,4762,25714
2000,10,17020,20483,369709,359767,2678,13.3,2146,10.6,70591,32287,38304,9,19.6,50706,19580,31126,5.4,14.1,19885,5.5,28.2,0,1212,1212,7039
2000,11,14742,17959,420477,413452,1767,9.9,1647,9.2,63604,22888,40716,5.5,15.4,49555,14160,35395,3.4,12,14049,3.4,24,0,859,859,6148
2000,12,296984,369079,6146445,6014073,49447,13.4,47516,12.9,1244372,475633,768739,7.9,20.7,979628,433188,546440,7.2,16.3,264744,4.4,32.6,0,29723,29723,201669
2000,13,136525,175134,3407368,3355840,22990,13.2,20683,11.9,625493,242657,382836,7.2,18.6,522438,215194,307244,6.4,15.6,103055,3,31.2,0,12378,12378,79942
2000,15,21406,26777,430528,422616,2660,10,2506,9.4,63043,23476,39567,5.6,14.9,47220,20650,26570,4.9,11.2,15823,3.7,22.4,0,1497,1497,8548
2000,16,26837,31990,442961,436045,4129,13,3780,11.9,80257,33796,46461,7.8,18.4,66425,24122,42303,5.5,15.2,13832,3.2,30.4,0,2305,2305,12297
2000,17,220130,272309,5404051,5335814,28274,10.4,26957,9.9,869196,294167,575029,5.5,16.3,732722,276346,456376,5.2,13.7,136474,2.6,27.4,0,16054,16054,109843
2000,18,102577,131892,2631699,2593040,13046,9.9,13309,10.1,396498,137739,258759,5.3,15.3,319180,117693,201487,4.5,12.3,77318,3,24.6,0,8024,8024,52546
2000,19,57722,72646,1273489,1250147,6598,9.1,6606,9.1,189360,66168,123192,5.3,15.1,142675,51686,90989,4.1,11.4,46685,3.7,22.8,0,4074,4074,22480
2000,20,53560,66493,1112892,1102222,7061,10.6,6821,10.3,177173,72320,104853,6.6,16.1,155835,57297,98538,5.2,14.1,21338,2,28.2,0,4153,4153,23088
2000,21,63907,81160,1502463,1477266,8477,10.5,8287,10.2,236814,89655,147159,6.1,16,186419,69323,117096,4.7,12.6,50395,3.4,25.2,0,5232,5232,34675
2000,22,71934,90889,1569484,1559029,9531,10.5,9645,10.6,264674,107273,157401,6.9,17,243764,91470,152294,5.9,15.6,20910,1.4,31.2,0,5824,5824,48243
2000,23,28597,33840,485050,474378,3711,11,3242,9.6,76848,29762,47086,6.3,16.2,55504,21671,33833,4.6,11.7,21344,4.5,23.4,0,2100,2100,11040
2000,24,90656,112476,2029468,1990097,12331,11,11662,10.4,355193,125096,230097,6.3,17.8,276451,106745,169706,5.4,13.9,78742,3.9,27.8,0,6837,6837,42113
2000,25,124069,151194,3029895,2982428,15613,10.4,14090,9.4,503845,168645,335200,5.7,16.9,408910,153432,255478,5.1,13.7,94935,3.2,27.4,0,8535,8535,58687
2000,26,166749,208597,4014492,3979100,21112,10.1,20624,9.9,636953,220770,416183,5.5,16,566171,221115,345056,5.6,14.2,70782,1.8,28.4,0,12093,12093,84037
2000,27,98618,121016,2385728,2349577,12525,10.4,11080,9.2,361775,119204,242571,5.1,15.4,289474,93738,195736,4,12.3,72301,3.1,24.6,0,6648,6648,44254
2000,28,42462,53669,946841,942438,5870,10.9,5940,11.1,136594,51636,84958,5.5,14.5,127788,46387,81401,4.9,13.6,8806,0.9,27.2,0,3804,3804,21377
2000,29,103797,129790,2371543,2349679,14137,10.9,13673,10.6,369460,134026,235434,5.7,15.7,325732,115017,210715,4.9,13.9,43728,1.8,27.8,0,8618,8618,49124
2000,30,23416,27189,294540,288981,3293,12.2,2934,10.9,50154,18903,31251,6.5,17.4,39036,14862,24174,5.1,13.5,11118,3.9,27,0,1913,1913,8158
2000,31,36078,44077,749968,741038,4361,9.9,3984,9.1,113052,43806,69246,5.9,15.3,95192,34325,60867,4.6,12.8,17860,2.5,25.6,0,2406,2406,16953
2000,32,33092,40749,896889,869240,6641,16.6,5357,13.4,179698,72114,107584,8.3,20.7,124400,47467,76933,5.5,14.3,55298,6.4,28.6,0,3312,3312,22549
2000,33,27967,33131,540077,530530,3503,10.6,3216,9.8,85859,29436,56423,5.5,16.2,66766,24178,42588,4.6,12.6,19093,3.6,25.2,0,1970,1970,11231
2000,34,173288,203567,3505376,3456600,22814,11.2,21309,10.5,607350,211730,395620,6.1,17.6,509798,197798,312000,5.7,14.7,97552,2.9,29.4,0,13449,13449,81044
2000,35,30581,37730,542216,538049,4468,11.8,4490,11.9,93725,38027,55698,7.1,17.4,85390,34766,50624,6.5,15.9,8335,1.5,31.8,0,2733,2733,16434
2000,36,363018,429059,7288831,7178005,47749,11.2,43678,10.2,1179829,419092,760737,5.8,16.4,958177,368817,589360,5.1,13.3,221652,3.1,26.6,0,28531,28531,170748
2000,37,141638,180802,3358426,3317681,20557,11.4,19148,10.6,534536,197335,337201,5.9,16.1,453047,171957,281090,5.2,13.7,81489,2.4,27.4,0,11751,11751,71637
2000,38,15073,18027,253528,250353,1559,8.6,1616,9,36202,13132,23070,5.2,14.5,29852,10451,19401,4.2,11.9,6350,2.6,23.8,0,1069,1069,6045
2000,39,188238,244720,4969745,4892725,23147,9.5,22688,9.3,780585,265036,515549,5.4,16,626547,221113,405434,4.5,12.8,154038,3.2,25.6,0,13556,13556,86956
2000,40,61070,75646,1194583,1175489,8310,11,8395,11.1,203899,79704,124195,6.8,17.3,165710,62834,102876,5.3,14.1,38189,3.2,28.2,0,5234,5234,28906
2000,41,72295,87439,1334947,1324924,10014,11.5,9974,11.4,218421,84082,134339,6.3,16.5,198375,77120,121255,5.8,15,20046,1.5,30,0,6119,6119,33199
2000,42,210447,266137,5039835,4971087,25125,9.5,23948,9,775090,291054,484036,5.9,15.6,637594,223589,414005,4.5,12.8,137496,2.8,25.6,0,14498,14498,88698
2000,44,22084,25111,407969,404722,2531,10.1,2382,9.5,67748,26429,41319,6.5,16.7,61253,26340,34913,6.5,15.1,6495,1.6,30.2,0,1542,1542,11528
2000,45,68344,86570,1582745,1560666,10080,11.7,9404,10.9,257931,93014,164917,6,16.5,213773,82786,130987,5.3,13.7,44158,2.8,27.4,0,5812,5812,35450
2000,46,17762,20926,300131,295618,2095,10,2007,9.6,46970,16498,30472,5.6,15.9,37943,14169,23774,4.8,12.8,9027,3.1,25.6,0,1291,1291,7058
2000,47,90450,118294,2372254,2339128,13103,11.1,13163,11.1,407681,150201,257480,6.4,17.4,341429,134809,206620,5.8,14.6,66252,2.8,29.2,0,7948,7948,49047
2000,48,318595,417447,7886105,7749247,51003,12.3,48855,11.7,1504391,569578,934813,7.4,19.4,1230676,501574,729102,6.5,15.9,273715,3.5,31.8,0,29168,29168,208499
2000,49,38193,47093,905182,889847,6721,14.5,5515,11.9,162075,61972,100103,7,18.2,131405,48409,82996,5.4,14.8,30670,3.4,29.6,0,3487,3487,24343
2000,50,16515,18914,252436,248029,1834,9.7,1662,8.8,38122,13189,24933,5.3,15.4,29307,10256,19051,4.1,11.8,8815,3.6,23.6,0,1083,1083,5465
2000,51,121162,156036,2847865,2788993,17668,11.4,15947,10.3,501691,184840,316851,6.6,18,383946,151059,232887,5.4,13.8,117745,4.2,27.6,0,9327,9327,51568
2000,53,116764,141812,2226523,2184773,17470,12.3,16919,12,402970,149129,253841,6.8,18.4,319471,119376,200095,5.5,14.6,83499,3.8,29.2,0,10371,10384,54359
2000,54,30005,37408,552311,544619,3640,9.7,3724,9.9,81924,31153,50771,5.7,15,66539,23560,42979,4.3,12.2,15385,2.8,24.4,0,2293,2293,12137
2000,55,101223,125363,2391518,2362182,12136,9.7,11169,8.9,331882,115863,216019,4.9,14,273210,95370,177840,4,11.6,58672,2.4,23.2,0,7020,7020,40792
2000,56,13540,15699,171590,168352,1838,11.8,1634,10.5,30470,11519,18951,6.8,18.1,23993,9230,14763,5.5,14.3,6477,3.8,28.6,0,1047,1047,4695
2001,01,69944,90025,1602980,1626673,9527,10.6,10346,11.5,220507,85494,135013,5.3,13.6,267892,92066,175826,5.7,16.5,-47385,-2.9,27.2,0,6197,6199,42560
2001,02,12678,15343,212079,208374,1864,12.2,1832,12,38069,13591,24478,6.5,18.3,30658,11250,19408,5.4,14.7,7411,3.6,29.4,0,972,972,5256
2001,04,79694,101651,1938976,1918356,14262,14.2,12434,12.4,373776,161875,211901,8.4,19.5,332537,128137,204400,6.7,17.3,41239,2.2,34.6,0,7096,7098,49511
2001,05,45032,56033,983559,986697,6273,11.2,6248,11.2,140053,50733,89320,5.1,14.2,146328,48306,98022,4.9,14.8,-6275,-0.6,28.4,0,3834,3835,21105
2001,06,571399,708631,13011439,12853482,91153,13,82934,11.8,2368618,880161,1488457,6.8,18.4,2052704,764787,1287917,6,16,315914,2.4,32,0,49615,49652,338175
2001,08,98877,120300,1953977,1922140,16889,14.2,14312,12.1,385410,154115,231295,8,20.1,321737,123560,198177,6.4,16.7,63673,3.4,33.4,0,8451,8455,51653
2001,09,68662,82835,1559907,1552569,8123,9.8,8104,9.8,228316,85479,142837,5.5,14.7,213640,78042,135598,5,13.8,14676,0.9,27.6,0,4756,4757,27516
2001,10,17461,21158,379507,375393,2586,12.4,2183,10.5,61908,21544,40364,5.7,16.5,53679,17766,35913,4.7,14.3,8229,2.2,28.6,0,1228,1229,8366
2001,11,14935,18263,428716,426146,1851,10.2,1708,9.4,64803,25164,39639,5.9,15.2,59663,21303,38360,5,14,5140,1.2,28,0,834,836,5526
2001,12,302106,377249,6433532,6314237,52274,14,47309,12.7,1314254,495122,819132,7.8,20.8,1075663,404388,671275,6.4,17,238591,3.8,34,0,28334,28352,174434
2001,13,138392,178374,3426360,3422997,23108,13.1,21280,12,567333,235825,331508,6.9,16.6,560608,198115,362493,5.8,16.4,6725,0.2,32.8,0,12062,12065,81194
2001,15,21797,27349,449481,442622,2842,10.5,2514,9.3,68153,29171,38982,6.6,15.4,54434,20825,33609,4.7,12.3,13719,3.1,24.6,0,1430,1432,10292
2001,16,27210,32501,464682,454862,4375,13.5,4205,13,88510,39078,49432,8.6,19.5,68869,26492,42377,5.8,15.1,19641,4.4,30.2,0,2280,2281,12995
2001,17,220398,274076,5382542,5404861,27505,10.1,27609,10.1,768592,286198,482394,5.3,14.2,813232,264824,548408,4.9,15,-44640,-0.8,28.4,0,16091,16113,103056
2001,18,102294,132320,2589615,2615485,13111,9.9,13701,10.4,350601,127014,223587,4.9,13.4,402341,130406,271935,5,15.4,-51740,-2,26.8,0,7875,7884,53717
2001,19,57289,72582,1247284,1263210,6332,8.7,7083,9.7,149758,55946,93812,4.4,11.9,181609,50672,130937,4,14.4,-31851,-2.5,23.8,0,4090,4091,22318
2001,20,53619,66947,1104171,1111170,6975,10.4,7139,10.7,149587,58989,90598,5.3,13.5,163585,55899,107686,5,14.7,-13998,-1.2,27,0,4205,4206,25623
2001,21,64049,81568,1496388,1503542,8280,10.2,8462,10.4,205694,73634,132060,4.9,13.7,220001,75444,144557,5,14.6,-14307,-0.9,27.4,0,4979,4986,30972
2001,22,72179,91480,1578800,1578606,9496,10.4,9722,10.6,245462,93278,152184,5.9,15.5,245075,82348,162727,5.2,15.5,387,0,31,0,5564,5566,35934
2001,23,28946,34493,492757,489722,3818,11.2,3456,10.1,70575,28614,41961,5.8,14.4,64505,21764,42741,4.4,13.2,6070,1.2,26.4,0,2117,2120,10394
2001,24,92068,114470,2075436,2056774,12957,11.4,11858,10.4,327856,126399,201457,6.1,15.9,290531,106544,183987,5.2,14.1,37325,1.8,28.2,0,6544,6550,45878
2001,25,126708,154531,3087093,3065034,15856,10.3,14960,9.7,479460,160205,319255,5.2,15.6,435342,147087,288255,4.8,14.2,44118,1.4,28.4,0,8721,8725,66905
2001,26,166342,209731,3970634,3998139,21307,10.2,21735,10.4,596004,228113,367891,5.7,14.9,651015,217635,433380,5.4,16.3,-55011,-1.4,29.8,0,12482,12489,87752
2001,27,99939,123789,2404206,2399005,13694,11.2,11798,9.6,343579,135742,207837,5.7,14.3,333178,111451,221727,4.6,13.9,10401,0.4,27.8,0,6682,6687,46186
2001,28,42100,53495,919298,935461,5734,10.7,6364,11.9,124301,47808,76493,5.1,13.3,156626,53983,102643,5.8,16.7,-32325,-3.4,26.6,0,3753,3753,21882
2001,29,103413,130311,2383562,2382147,13378,10.3,13917,10.7,342773,127103,215670,5.3,14.4,339945,113734,226211,4.8,14.3,2828,0.1,28.6,0,8459,8461,49673
2001,30,23852,27812,300521,298356,3281,11.9,2963,10.8,48119,19130,28989,6.4,16.1,43789,14328,29461,4.8,14.7,4330,1.4,29.4,0,1752,1753,8125
2001,31,36406,44724,746965,749552,4460,10,4290,9.6,103507,44434,59073,5.9,13.8,108680,38589,70091,5.1,14.5,-5173,-0.7,27.6,0,2408,2408,13455
2001,32,33891,41920,914870,907096,6678,16.1,5856,14.2,158278,65893,92385,7.3,17.4,142729,50433,92296,5.6,15.7,15549,1.7,31.4,0,3582,3584,25955
2001,33,28145,33445,554463,547963,3499,10.5,3389,10.2,85353,29307,56046,5.3,15.6,72353,26038,46315,4.8,13.2,13000,2.4,26.4,0,2063,2064,12603
2001,34,175063,206569,3606257,3563025,23262,11.3,21951,10.7,610341,240890,369451,6.8,17.1,523877,182706,341171,5.1,14.7,86464,2.4,29.4,0,13346,13347,85222
2001,35,30774,38131,548728,546938,4578,12.1,4550,12,96051,38876,57175,7.1,17.6,92471,34788,57683,6.4,16.9,3580,0.7,33.8,0,2497,2497,14767
2001,36,368613,435878,7358785,7342423,48541,11.2,45728,10.5,1078820,400677,678143,5.5,14.7,1046096,374608,671488,5.1,14.2,32724,0.5,28.4,0,28441,28461,174109
2001,37,143568,183926,3436546,3406151,21575,11.8,19914,10.9,577481,214223,363258,6.3,17,516692,182987,333705,5.4,15.2,60789,1.8,30.4,0,11493,11500,66882
2001,38,15086,18151,255216,254796,1588,8.8,1639,9,33033,13755,19278,5.4,13,32192,10192,22000,4,12.6,841,0.4,25.2,0,1000,1000,5891
2001,39,187800,245998,4908723,4949147,23095,9.4,23364,9.5,662135,246386,415749,5,13.4,742982,230190,512792,4.7,15,-80847,-1.6,26.8,0,13423,13444,88090
2001,40,61201,76322,1202937,1201711,8402,11,8498,11.2,193338,74467,118871,6.2,16.1,190887,74238,116649,6.2,15.9,2451,0.2,31.8,0,5097,5099,29226
2001,41,73206,89075,1342713,1341484,10769,12.2,10097,11.4,210760,80225,130535,6,15.7,208302,65910,142392,4.9,15.5,2458,0.2,31,0,5981,5993,30655
2001,42,211582,269387,5089170,5074989,25913,9.7,24685,9.2,730674,280974,449700,5.5,14.4,702311,236173,466138,4.7,13.8,28363,0.6,27.6,0,14410,14416,97846
2001,44,22226,25350,407891,408389,2523,10,2461,9.7,53051,19288,33763,4.7,13,54047,15433,38614,3.8,13.2,-996,-0.2,26,0,1549,1549,7742
2001,45,68591,87289,1585468,1589658,10050,11.5,10038,11.5,239806,93277,146529,5.9,15.1,248186,82468,165718,5.2,15.6,-8380,-0.5,30.2,0,6004,6009,36357
2001,46,17903,21198,312682,307900,2148,10.2,2125,10.1,50045,22592,27453,7.3,16.3,40480,13000,27480,4.2,13.1,9565,3.2,26.2,0,1251,1252,6609
2001,47,89932,118501,2360525,2370562,12811,10.8,13509,11.4,358668,131928,226740,5.6,15.1,378741,134588,244153,5.7,16,-20073,-0.9,30.2,0,7899,7905,58086
2001,48,322309,425543,8065449,7990254,53003,12.6,48836,11.6,1465416,603497,861919,7.6,18.3,1315026,507173,807853,6.3,16.5,150390,1.8,33,0,28655,28682,196233
2001,49,39288,48305,909992,909500,7133,14.9,6324,13.2,166187,65353,100834,7.2,18.3,165203,66401,98802,7.3,18.2,984,0.1,36.4,0,3523,3528,27749
2001,50,16646,19155,259608,256558,1750,9.2,1690,8.9,34497,12198,22299,4.8,13.4,28396,9532,18864,3.7,11.1,6101,2.3,22.2,0,1084,1084,5399
2001,51,123022,158779,2908434,2885172,17854,11.3,16430,10.4,481807,189811,291996,6.6,16.7,435282,138425,296857,4.8,15.1,46525,1.6,30.2,0,9107,9112,54802
2001,53,117733,143923,2246235,2240956,18076,12.6,17248,12.1,371260,145408,225852,6.5,16.6,360702,126343,234359,5.6,16.1,10558,0.5,32.2,0,10084,10095,62798
2001,54,29540,36987,549829,552784,3302,8.9,4006,10.8,75460,26161,49299,4.7,13.7,81371,30460,50911,5.5,14.7,-5911,-1,27.4,0,2339,2340,11187
2001,55,101603,126533,2382130,2390908,11968,9.5,11797,9.4,300815,112822,187993,4.7,12.6,318371,101143,217228,4.2,13.3,-17556,-0.7,25.2,0,6965,6976,42174
2001,56,13730,15934,175238,173823,1860,11.7,1824,11.5,29005,11087,17918,6.4,16.7,26175,9170,17005,5.3,15.1,2830,1.6,30.2,0,1065,1066,5007
2002,01,70077,90514,1571844,1588248,10991,12.2,10373,11.5,255732,105218,150514,6.6,16.1,288539,99095,189444,6.2,18.2,-32807,-2.1,32.2,0,5783,5792,34380
2002,02,12843,15592,214177,212680,2236,14.5,1924,12.5,40747,15967,24780,7.5,19.2,37752,11891,25861,5.6,17.8,2995,1.4,35.6,0,932,934,4977
2002,04,80863,103369,1919463,1927572,15428,15.1,13663,13.3,381462,159839,221623,8.3,19.8,397681,137727,259954,7.1,20.6,-16219,-0.8,39.6,0,7333,7355,49935
2002,05,45485,56845,973257,977695,7343,13,6439,11.4,159841,67379,92462,6.9,16.3,168716,62453,106263,6.4,17.3,-8875,-1,32.6,0,3703,3707,20029
2002,06,576942,717239,12684526,12818076,101565,14.3,91260,12.8,2375613,1015751,1359862,7.9,18.5,2642714,950800,1691914,7.4,20.6,-267101,-2.1,37,0,51010,51162,401927
2002,08,99866,121531,1872056,1912195,17767,14.7,16288,13.5,340728,146320,194408,7.7,17.8,421005,160128,260877,8.4,22,-80277,-4.2,35.6,0,8576,8590,51313
2002,09,68260,82553,1556405,1554153,8852,10.7,8968,10.9,250850,99528,151322,6.4,16.1,246346,79390,166956,5.1,15.9,4504,0.2,31.8,0,4544,4547,27319
2002,10,17517,21580,385852,383522,2902,13.6,2437,11.4,69428,32164,37264,8.4,18.1,64767,21594,43173,5.6,16.9,4661,1.2,33.8,0,1234,1240,6142
2002,11,15152,18529,427599,427741,2295,12.5,2025,11,71951,31071,40880,7.3,16.8,72235,23079,49156,5.4,16.9,-284,-0.1,33.6,0,865,868,7973
2002,12,308428,383859,6272310,6304447,58518,15.4,51516,13.5,1225611,507347,718264,8,19.4,1289885,575265,714620,9.1,20.5,-64274,-1.1,38.8,0,28433,28494,191699
2002,13,140616,180878,3365147,3393411,25802,14.4,23077,12.9,593691,267020,326671,7.9,17.5,650219,243870,406349,7.2,19.2,-56528,-1.7,35,0,11952,11977,90644
2002,15,22048,27588,439692,445033,3229,11.8,2943,10.7,67196,27456,39740,6.2,15.1,77878,23247,54631,5.2,17.5,-10682,-2.4,30.2,0,1511,1515,8821
2002,16,27706,33112,453340,458027,4788,14.6,4088,12.5,83330,37873,45457,8.3,18.2,92703,32204,60499,7,20.2,-9373,-2,36.4,0,2093,2112,16533
2002,17,219136,273122,5189473,5279031,31177,11.4,31806,11.6,808218,333176,475042,6.3,15.3,987335,340090,647245,6.4,18.7,-179117,-3.4,30.6,0,15654,15725,107232
2002,18,102674,132863,2514481,2546235,15292,11.5,14632,11,378507,161667,216840,6.3,14.9,442016,142473,299543,5.6,17.4,-63509,-2.5,29.8,0,7349,7378,47962
2002,19,57207,72588,1229564,1235896,7519,10.4,7357,10.1,171165,72984,98181,5.9,13.8,183828,61542,122286,5,14.9,-12663,-1.1,27.6,0,3671,3682,21751
2002,20,53656,67138,1095866,1098925,7952,11.9,7672,11.5,179492,76975,102517,7,16.3,185610,62384,123226,5.7,16.9,-6118,-0.6,32.6,0,4004,4011,22995
2002,21,64117,82105,1468440,1480511,9406,11.5,8778,10.7,223243,91147,132096,6.2,15.1,247385,75575,171810,5.1,16.7,-24142,-1.6,30.2,0,4805,4821,28352
2002,22,72883,92272,1563055,1568055,10721,11.7,9831,10.7,263838,107376,156462,6.8,16.8,273839,95474,178365,6.1,17.5,-10001,-0.7,33.6,0,5323,5333,39257
2002,23,28897,34629,480494,485972,4072,11.8,3934,11.4,71013,30160,40853,6.2,14.6,81968,28769,53199,5.9,16.9,-10955,-2.3,29.2,0,2049,2050,12442
2002,24,93310,115980,2052907,2057930,14648,12.7,12973,11.3,344850,145830,199020,7.1,16.8,354896,127418,227478,6.2,17.2,-10046,-0.4,33.6,0,6443,6456,48761
2002,25,126934,155655,2992697,3034533,17807,11.5,16443,10.6,477634,193803,283831,6.4,15.7,561305,190309,370996,6.3,18.5,-83671,-2.8,31.4,0,8493,8501,64209
2002,26,165183,208342,3868246,3916952,24375,11.7,25407,12.2,628709,270925,357784,6.9,16.1,726121,258412,467709,6.6,18.5,-97412,-2.4,32.2,0,12314,12353,86366
2002,27,99908,124221,2360231,2376190,14588,11.8,14002,11.3,366346,143375,222971,6,15.4,398265,134671,263594,5.7,16.8,-31919,-1.4,30.8,0,6829,6841,45248
2002,28,42445,53952,899440,906736,6656,12.4,6165,11.5,141743,61746,79997,6.8,15.6,156334,56410,99924,6.2,17.2,-14591,-1.6,31.2,0,3472,3478,20344
2002,29,104206,131575,2343702,2361022,16576,12.7,15145,11.6,376841,156986,219855,6.6,16,411481,138992,272489,5.9,17.4,-34640,-1.4,32,0,8174,8183,53275
2002,30,24027,28084,299573,299093,3588,12.8,3268,11.7,51233,20529,30704,6.9,17.1,50272,16357,33915,5.5,16.8,961,0.3,33.6,0,1755,1756,7788
2002,31,36585,45065,746748,745089,4951,11,4559,10.2,111360,41540,69820,5.6,14.9,108042,34362,73680,4.6,14.5,3318,0.4,29,0,2372,2376,12600
2002,32,34901,43335,930800,927089,7492,17.6,6002,14.1,177626,79909,97717,8.6,19.2,170203,54283,115920,5.9,18.4,7423,0.8,36.8,0,3423,3425,24374
2002,33,28009,33463,537530,544591,3790,11.3,3717,11.1,78753,30642,48111,5.6,14.5,92874,32762,60112,6,17.1,-14121,-2.6,29,0,2046,2047,11745
2002,34,175184,207594,3575302,3579695,25434,12.3,24119,11.7,613835,233694,380141,6.5,17.1,622621,215036,407585,6,17.4,-8786,-0.3,34.2,0,13393,13414,81982
2002,35,31067,38353,550167,547163,5033,13.2,4763,12.5,103200,44765,58435,8.2,18.9,97192,35348,61844,6.5,17.8,6008,1.1,35.6,0,2439,2440,14833
2002,36,369756,437453,7269373,7307112,53883,12.4,51539,11.8,1236587,509627,726960,7,16.9,1312064,495949,816115,6.8,18,-75477,-1.1,33.8,0,29028,29059,183648
2002,37,143912,184890,3335021,3379608,22739,12.3,21563,11.7,517015,223471,293544,6.6,15.3,606189,201709,404480,6,17.9,-89174,-2.6,30.6,0,11442,11477,67807
2002,38,14977,18155,252443,253617,1795,9.9,1746,9.6,37678,17757,19921,7,14.9,40025,13636,26389,5.4,15.8,-2347,-0.9,29.8,0,925,925,5854
2002,39,186689,244789,4754081,4821129,25753,10.5,26668,10.9,727882,289367,438515,6,15.1,861978,271503,590475,5.6,17.9,-134096,-2.8,30.2,0,13067,13096,93834
2002,40,62013,77044,1189101,1192062,9589,12.5,8780,11.5,209352,86079,123273,7.2,17.6,215273,79837,135436,6.7,18.1,-5921,-0.5,35.2,0,4748,4765,32902
2002,41,73305,89479,1319922,1329790,11457,12.8,10834,12.2,221152,95654,125498,7.2,16.6,240887,81174,159713,6.1,18.1,-19735,-1.5,33.2,0,5796,5811,32834
2002,42,211471,269383,5060581,5067158,28418,10.6,28005,10.4,820249,336093,484156,6.6,16.2,833403,319300,514103,6.3,16.4,-13154,-0.2,32.4,0,13921,13966,99813
2002,44,22155,25365,413953,411589,2820,11.1,2762,10.9,64649,26949,37700,6.5,15.7,59921,19180,40741,4.7,14.6,4728,1.1,29.2,0,1465,1465,7185
2002,45,69041,88108,1532010,1553749,11069,12.6,10240,11.7,242314,101660,140654,6.5,15.6,285794,90436,195358,5.8,18.4,-43480,-2.8,31.2,0,5673,5684,35152
2002,46,18176,21627,302223,307387,2647,12.4,2180,10.2,49317,18589,30728,6,16,59645,23317,36328,7.6,19.4,-10328,-3.4,32,0,1223,1223,7221
2002,47,89467,118103,2283920,2317203,14063,11.9,14299,12.1,363630,147901,215729,6.4,15.7,430195,151102,279093,6.5,18.6,-66565,-2.9,31.4,0,7673,7698,50428
2002,48,326189,430507,7950737,7985108,58380,13.6,52959,12.4,1495256,670544,824712,8.4,18.7,1564000,567821,996179,7.1,19.6,-68744,-0.9,37.4,0,28205,28305,194401
2002,49,40563,49692,906394,908421,8077,16.5,6580,13.4,167443,73245,94198,8.1,18.4,171496,60762,110734,6.7,18.9,-4053,-0.5,36.8,0,3412,3418,26180
2002,50,16540,19030,258984,259289,1962,10.3,2077,10.9,39838,16039,23799,6.2,15.4,40448,14651,25797,5.7,15.6,-610,-0.2,30.8,0,1052,1053,5950
2002,51,124823,161150,2893166,2901575,20335,12.7,17816,11.1,492890,206894,285996,7.1,17,509708,185609,324099,6.4,17.6,-16818,-0.6,34,0,9013,9032,60569
2002,53,117722,144263,2180420,2208713,19689,13.7,18940,13.2,380448,181095,199353,8.2,17.2,437034,139819,297215,6.3,19.8,-56586,-2.6,34.4,0,10245,10267,61774
2002,54,29297,36872,556153,552933,3971,10.8,4058,11,92040,31672,60368,5.7,16.6,85600,30836,54764,5.6,15.5,6440,1.1,31,0,2191,2196,11746
2002,55,101507,126757,2354981,2368803,13623,10.8,13193,10.4,335487,131810,203677,5.6,14.2,363130,114042,249088,4.8,15.3,-27643,-1.1,28.4,0,6802,6821,44492
2002,56,14094,16311,176217,175727,2247,13.9,1843,11.4,33508,13691,19817,7.8,19.1,32527,13177,19350,7.5,18.5,981,0.6,37,0,1014,1015,5185
2003,01,70389,91024,1588110,1568996,10017,11.1,7888,8.7,250334,90416,159918,5.8,16,212105,62743,149362,4,13.5,38229,2.5,27,0,5758,5760,34078
2003,02,13024,15833,219243,215035,2090,13.4,1509,9.7,41010,15157,25853,7,19.1,32594,9520,23074,4.4,15.2,8416,3.9,30.4,0,893,893,4825
2003,04,82422,105379,1962042,1925357,14952,14.4,10806,10.4,384110,147241,236869,7.6,20,310740,102398,208342,5.3,16.1,73370,3.9,32.2,0,7307,7326,56271
2003,05,46058,57745,981466,970507,6808,11.9,4963,8.7,140656,47854,92802,4.9,14.5,118738,34011,84727,3.5,12.2,21918,2.3,24.4,0,3674,3680,19933
2003,06,584851,726275,12826339,12663136,97057,13.5,74727,10.4,2306667,868476,1438191,6.9,18.2,1980262,642430,1337832,5.1,15.6,326405,2.6,31.2,0,51510,52205,375679
2003,08,101302,123153,1852087,1849474,17237,14.2,13279,10.9,317723,132282,185441,7.2,17.2,312498,109388,203110,5.9,16.9,5225,0.3,33.8,0,8630,8642,57235
2003,09,67782,82021,1545861,1540149,7787,9.5,7201,8.8,212475,61698,150777,4,13.8,201051,65692,135359,4.3,13.1,11424,0.7,26.2,0,4611,4617,27701
2003,10,17769,21872,380286,381541,2620,12.1,1963,9.1,51695,19469,32226,5.1,13.5,54205,17962,36243,4.7,14.2,-2510,-0.7,27,0,1290,1292,7643
2003,11,15058,18440,427238,423505,1733,9.4,1493,8.1,59384,19317,40067,4.6,14,51918,13227,38691,3.1,12.3,7466,1.7,24.6,0,893,893,6472
2003,12,318351,394031,6394545,6279440,60406,15.6,42614,11,1287179,525256,761923,8.4,20.5,1056970,401009,655961,6.4,16.8,230209,3.7,33.6,0,29592,29664,219878
2003,13,143256,183617,3350794,3328426,24713,13.6,18127,10,545838,215831,330007,6.5,16.4,501102,153700,347402,4.6,15.1,44736,1.3,30.2,0,12107,12122,78635
2003,15,22481,28057,458374,447271,3056,11,2147,7.8,71391,23990,47401,5.4,16,49185,18088,31097,4,11,22206,5,22,0,1470,1470,10795
2003,16,28547,34059,465039,456694,4805,14.4,3273,9.8,79168,28691,50477,6.3,17.3,62477,19630,42847,4.3,13.7,16691,3.6,27.4,0,2198,2209,11615
2003,17,220163,274745,5192476,5159626,29869,11,24031,8.8,764903,261102,503801,5.1,14.8,699202,217835,481367,4.2,13.6,65701,1.2,27.2,0,15508,15604,110540
2003,18,102801,133203,2537000,2507247,13499,10.2,10945,8.3,379318,126939,252379,5.1,15.1,319812,100396,219416,4,12.8,59506,2.3,25.6,0,7372,7443,51394
2003,19,57316,72666,1227166,1220835,7085,9.8,5830,8.1,158798,57208,101590,4.7,13,146135,41229,104906,3.4,12,12663,1,24,0,3751,3753,24463
2003,20,53796,67382,1103577,1091202,7241,10.8,5852,8.7,165547,68117,97430,6.2,15.2,140796,45037,95759,4.1,12.9,24751,2.3,25.8,0,4015,4026,23483
2003,21,64051,82328,1475753,1464469,8384,10.2,6883,8.4,211892,74923,136969,5.1,14.5,189323,56828,132495,3.9,12.9,22569,1.6,25.8,0,4820,4858,31592
2003,22,73479,92862,1587949,1564329,9843,10.7,7552,8.2,255210,85311,169899,5.5,16.3,207970,62419,145551,4,13.3,47240,3,26.6,0,5399,5406,37997
2003,23,29212,35019,481760,478773,3840,11.1,2968,8.6,68097,25387,42710,5.3,14.2,62123,20308,41815,4.2,13,5974,1.2,26,0,1927,1930,10872
2003,24,94754,117670,2077473,2050427,13577,11.7,9990,8.6,327506,117415,210091,5.7,16,273414,79347,194067,3.9,13.3,54092,2.7,26.6,0,6499,6500,41351
2003,25,128664,157413,2963879,2959415,17776,11.4,13751,8.8,423469,143060,280409,4.8,14.3,414541,135946,278595,4.6,14,8928,0.3,28,0,8819,8836,60245
2003,26,164940,208078,3845152,3831397,22109,10.7,19051,9.2,595553,220160,375393,5.7,15.5,568045,168444,399601,4.4,14.8,27508,0.7,29.6,0,12311,12430,99286
2003,27,101285,125911,2375712,2355742,14378,11.5,10695,8.6,360579,137249,223330,5.8,15.3,320639,96595,224044,4.1,13.6,39940,1.7,27.2,0,6656,6659,47174
2003,28,42757,54397,904095,895194,6213,11.5,4795,8.9,139847,51295,88552,5.7,15.6,122044,36020,86024,4,13.6,17803,2,27.2,0,3530,3533,23720
2003,29,105596,133144,2377116,2346532,15854,12,12082,9.2,354360,115837,238523,4.9,15.1,293192,90699,202493,3.9,12.5,61168,2.6,25,0,8386,8394,49876
2003,30,24613,28690,305231,301191,3559,12.6,2558,9,49522,19833,29689,6.6,16.4,41442,12935,28507,4.3,13.8,8080,2.6,27.6,0,1660,1661,7754
2003,31,36878,45452,758879,746681,4581,10.2,3538,7.9,117107,38431,78676,5.1,15.7,92710,25809,66901,3.5,12.4,24397,3.3,24.8,0,2351,2352,12748
2003,32,36379,45098,963681,943439,7627,17.4,4950,11.3,173593,70464,103129,7.5,18.4,133108,41795,91313,4.4,14.1,40485,4.3,28.2,0,3478,3485,23116
2003,33,28078,33604,531365,529778,3682,11,3082,9.2,75931,29234,46697,5.5,14.3,72757,22853,49904,4.3,13.7,3174,0.6,27.4,0,2079,2080,11890
2003,34,175699,208335,3557137,3541138,24638,11.9,21006,10.1,578039,208681,369358,5.9,16.3,546041,176634,369407,5,15.4,31998,0.9,30.8,0,13887,13901,91754
2003,35,31396,38724,569310,557231,4662,12.2,3578,9.3,99546,38774,60772,7,17.9,75388,26964,48424,4.8,13.5,24158,4.4,27,0,2349,2355,13916
2003,36,374131,442102,7357272,7280882,52871,12.1,42837,9.8,1152037,393085,758952,5.4,15.8,999258,314016,685242,4.3,13.7,152779,2.1,27.4,0,29545,29582,180548
2003,37,145137,186530,3334631,3312400,21998,11.9,16816,9.1,532024,211300,320724,6.4,16.1,487561,151840,335721,4.6,14.7,44463,1.4,29.4,0,11385,11407,71088
2003,38,15017,18201,258242,254197,1606,8.9,1311,7.2,35432,11199,24233,4.4,13.9,27342,8546,18796,3.4,10.8,8090,3.1,21.6,0,843,843,4879
2003,39,186122,244400,4752810,4723630,23741,9.8,20094,8.3,686623,232696,453927,4.9,14.5,628263,178901,449362,3.8,13.3,58360,1.2,26.6,0,13109,13178,93232
2003,40,62290,77491,1172294,1172193,8663,11.3,6868,8.9,179265,61419,117846,5.2,15.3,179063,52769,126294,4.5,15.3,202,0,30.6,0,5035,5039,30479
2003,41,74412,90720,1332026,1318704,11231,12.5,8382,9.3,211882,67079,144803,5.1,16.1,185237,61645,123592,4.7,14,26645,2.1,28,0,5655,5660,32614
2003,42,211726,270120,5056467,5026353,26358,9.8,21653,8.1,741303,254344,486959,5.1,14.7,681075,189728,491347,3.8,13.6,60228,1.1,27.2,0,14244,14308,95614
2003,44,22410,25649,420290,415644,2840,11.2,2240,8.8,62267,21020,41247,5.1,15,52975,15318,37657,3.7,12.7,9292,2.3,25.4,0,1412,1420,8217
2003,45,69949,89195,1535482,1523515,10565,12,7889,8.9,245086,100371,144715,6.6,16.1,221153,68511,152642,4.5,14.5,23933,1.6,29,0,5619,5624,36313
2003,46,18242,21602,294882,295917,2255,10.5,1900,8.8,41040,14408,26632,4.9,13.9,43109,18019,25090,6.1,14.6,-2069,-0.7,27.8,0,1204,1204,6292
2003,47,89753,118634,2292268,2270881,13491,11.5,10789,9.2,363558,137790,225768,6.1,16,320783,93757,227026,4.1,14.1,42775,1.9,28.2,0,7466,7478,49607
2003,48,329597,434347,7944987,7883519,55434,12.9,42723,9.9,1405409,559664,845745,7.1,17.8,1282474,448254,834220,5.7,16.3,122935,1.5,32.6,0,29295,29446,223940
2003,49,41930,51004,904621,899056,8091,16.1,5868,11.7,161175,70890,90285,7.9,17.9,150045,52601,97444,5.9,16.7,11130,1.2,33.4,0,3807,3814,31165
2003,50,16607,19194,256737,256541,2003,10.5,1578,8.3,36108,12673,23435,4.9,14.1,35715,11740,23975,4.6,13.9,393,0.2,27.8,0,1033,1034,6301
2003,51,126692,163596,2902072,2879374,19359,12,14040,8.7,444856,163043,281813,5.7,15.4,399460,124259,275201,4.3,13.9,45396,1.5,27.8,0,9154,9206,62298
2003,53,119368,145955,2199087,2176370,19070,13.2,14668,10.2,358954,131187,227767,6,16.5,313521,105550,207971,4.8,14.4,45433,2.1,28.8,0,9784,9801,52630
2003,54,29068,36719,555138,552460,3580,9.8,3054,8.3,78593,31680,46913,5.7,14.2,73237,19512,53725,3.5,13.3,5356,0.9,26.6,0,2087,2092,11823
2003,55,101373,126867,2376516,2353500,12450,9.9,10518,8.3,328253,113807,214446,4.8,13.9,282220,80976,201244,3.4,12,46033,1.9,24,0,6924,6949,44342
2003,56,14253,16463,177143,175244,2006,12.3,1588,9.7,29353,10152,19201,5.8,16.7,25555,8418,17137,4.8,14.6,3798,2.1,29.2,0,1063,1068,5063
2004,01,71030,91635,1612457,1593465,9704,10.7,8192,9,253166,84394,168772,5.3,15.9,215181,74582,140599,4.7,13.5,37985,2.4,27,0,5541,5556,35392
2004,02,13232,16068,223056,219737,2043,12.9,1602,10.1,35792,10959,24833,5,16.3,29154,10056,19098,4.6,13.3,6638,3,26.6,0,965,965,5012
2004,04,84566,107925,2011433,1977291,14825,13.9,10886,10.2,365319,131641,233678,6.7,18.5,297034,104476,192558,5.3,15,68285,3.5,30,0,7127,7142,56581
2004,05,46617,58378,993312,981830,6384,11,5260,9.1,141607,45658,95949,4.7,14.4,118644,37396,81248,3.8,12.1,22963,2.3,24.2,0,3732,3738,20883
2004,06,590973,732203,13013677,12857225,92650,12.7,77649,10.7,2241501,832114,1409387,6.5,17.4,1928597,692822,1235775,5.4,15,312904,2.4,30,0,52216,52330,382609
2004,08,103024,125166,1882012,1859698,16774,13.5,13420,10.8,318349,132009,186340,7.1,17.1,273720,94918,178802,5.1,14.7,44629,2.4,29.4,0,8565,8587,50440
2004,09,68204,82674,1522284,1528447,8149,9.9,6792,8.3,191483,63325,128158,4.1,12.5,203810,74204,129606,4.9,13.3,-12327,-0.8,25,0,4370,4381,36689
2004,10,18122,22370,386021,383101,2678,12.1,1985,9,56219,20542,35677,5.4,14.7,50379,17891,32488,4.7,13.2,5840,1.5,26.4,0,1251,1258,6988
2004,11,14643,18110,437711,431361,1398,7.7,1550,8.5,58757,17627,41130,4.1,13.6,46056,13441,32615,3.1,10.7,12701,2.9,21.4,0,901,906,6219
2004,12,334147,410603,6482905,6415540,66023,16.4,44930,11.2,1254432,471338,783094,7.3,19.6,1119702,486440,633262,7.6,17.5,134730,2.1,35,0,30541,30753,206345
2004,13,146935,187539,3422142,3367663,24233,13.1,18134,9.8,581878,210294,371584,6.2,17.3,472919,161569,311350,4.8,14,108959,3.3,28,0,11921,11960,78683
2004,15,22874,28569,472094,464422,3007,10.6,2266,8,66164,22358,43806,4.8,14.2,50819,16405,34414,3.5,10.9,15345,3.3,21.8,0,1509,1509,9510
2004,16,29555,35133,485805,473118,4774,13.8,3374,9.8,87473,40933,46540,8.7,18.5,62098,21571,40527,4.6,13.1,25375,5.4,26.2,0,2136,2144,10303
2004,17,222385,276780,5211954,5181021,29344,10.7,24749,9,749819,244223,505596,4.7,14.5,687953,215137,472816,4.2,13.3,61866,1.2,26.6,0,15326,15419,106565
2004,18,103599,134402,2576495,2548059,13434,10.1,10980,8.2,360406,119741,240665,4.7,14.1,303534,98076,205458,3.8,11.9,56872,2.2,23.8,0,7304,7311,49983
2004,19,57614,72962,1235262,1226941,6696,9.2,5895,8.1,158865,49847,109018,4.1,12.9,142223,46945,95278,3.8,11.6,16642,1.3,23.2,0,3776,3785,20449
2004,20,54318,67890,1104795,1102299,6977,10.3,5827,8.6,149147,55228,93919,5,13.5,144156,45888,98268,4.2,13.1,4991,0.4,26.2,0,3816,3818,23437
2004,21,64571,82909,1487189,1469536,8383,10.2,7014,8.5,216630,77019,139611,5.2,14.7,181326,61654,119672,4.2,12.3,35304,2.4,24.6,0,4710,4716,32086
2004,22,74281,93648,1602220,1590616,9440,10.1,7831,8.4,242324,75305,167019,4.7,15.2,219116,71414,147702,4.5,13.8,23208,1.4,27.6,0,5313,5330,38543
2004,23,29527,35386,485637,482117,3759,10.7,3083,8.8,61476,20003,41473,4.1,12.8,54436,18881,35555,3.9,11.3,7040,1.5,22.6,0,2024,2039,10874
2004,24,96808,119855,2132984,2098798,13569,11.5,10333,8.7,334282,114267,220015,5.4,15.9,265911,92193,173718,4.4,12.7,68371,3.2,25.4,0,6570,6587,47411
2004,25,127072,155806,2967496,2957921,15915,10.2,16230,10.4,393746,137182,256564,4.6,13.3,374597,118890,255707,4,12.7,19149,0.6,25.4,0,11444,11469,56978
2004,26,165233,207693,3845761,3829976,21276,10.3,19453,9.4,559606,205579,354027,5.4,14.6,528036,176339,351697,4.6,13.8,31570,0.8,27.6,0,12029,12098,88558
2004,27,102969,127848,2379720,2371469,14153,11.2,10985,8.7,319723,107975,211748,4.6,13.5,303221,103988,199233,4.4,12.8,16502,0.7,25.6,0,6708,6723,48008
2004,28,43115,54880,921870,910625,5819,10.7,4873,8.9,138969,52764,86205,5.8,15.3,116478,40481,75997,4.4,12.8,22491,2.5,25.6,0,3385,3396,19426
2004,29,107735,135422,2393664,2375540,16213,12.1,12649,9.4,350739,125140,225599,5.3,14.8,314492,109517,204975,4.6,13.2,36247,1.6,26.4,0,8641,8644,53336
2004,30,25346,29441,312676,307386,3783,13,2739,9.4,48937,16973,31964,5.5,15.9,38357,15246,23111,5,12.5,10580,3.4,25,0,1722,1723,8221
2004,31,37146,45736,771513,762719,4373,9.6,3692,8.1,97649,34275,63374,4.5,12.8,80063,23282,56781,3.1,10.5,17586,2.3,21,0,2392,2413,12664
2004,32,38027,46978,1014908,985030,7754,16.9,5290,11.5,190319,70770,119549,7.2,19.3,130562,49128,81434,5,13.3,59757,6,26.6,0,3598,3617,26286
2004,33,28530,34129,537813,533310,3776,11.2,2972,8.8,68584,22461,46123,4.2,12.9,59578,20818,38760,3.9,11.2,9006,1.7,22.4,0,2003,2020,12458
2004,34,177637,209227,3586965,3550917,24187,11.6,21544,10.3,564886,182957,381929,5.2,15.9,492792,167233,325559,4.7,13.9,72094,2,27.8,0,13785,13816,83009
2004,35,31864,39221,576036,569294,4497,11.6,3600,9.3,92999,33148,59851,5.8,16.3,79515,29103,50412,5.1,14,13484,2.3,28,0,2352,2352,14107
2004,36,378394,446777,7392979,7350398,53167,12,45249,10.2,1090006,369065,720941,5,14.8,1004844,324709,680135,4.4,13.7,85162,1.1,27.4,0,30312,30374,181217
2004,37,147765,189305,3340600,3319460,21541,11.5,16770,8.9,498723,169950,328773,5.1,15,456443,148505,307938,4.5,13.8,42280,1.2,27.6,0,11079,11119,73032
2004,38,15238,18416,261911,259181,1662,9.1,1315,7.2,32925,10083,22842,3.9,12.7,27465,11350,16115,4.4,10.6,5460,2.1,21.2,0,872,872,4867
2004,39,186189,244899,4738502,4726164,23242,9.5,20294,8.3,628034,211660,416374,4.5,13.3,603359,200996,402363,4.3,12.8,24675,0.5,25.6,0,13006,13057,104142
2004,40,62993,78328,1181894,1171524,8482,10.9,6922,8.9,182624,65494,117130,5.6,15.6,161884,50084,111800,4.3,13.8,20740,1.8,27.6,0,4758,4792,27692
2004,41,75631,92243,1345667,1334221,11116,12.2,8759,9.6,197636,72832,124804,5.5,14.8,174745,65742,109003,4.9,13.1,22891,1.7,26.2,0,5788,5798,31602
2004,42,213608,272071,5083446,5054253,26065,9.6,21872,8.1,700005,227768,472237,4.5,13.8,641619,233421,408198,4.6,12.7,58386,1.1,25.4,0,14038,14056,115152
2004,44,22957,26308,432434,425119,2960,11.4,2141,8.3,61924,19763,42161,4.6,14.6,47295,15516,31779,3.6,11.1,14629,3.5,22.2,0,1450,1451,8989
2004,45,71160,90634,1538815,1530224,10368,11.6,8021,8.9,228690,85524,143166,5.6,14.9,211509,69967,141542,4.6,13.8,17181,1.1,27.6,0,5482,5483,35909
2004,46,18550,21933,302379,297732,2284,10.5,1810,8.3,44517,14061,30456,4.7,15,35222,13026,22196,4.4,11.8,9295,3.2,23.6,0,1212,1212,6461
2004,47,90970,120055,2333753,2303377,13153,11.1,10513,8.8,352619,124063,228556,5.4,15.3,291866,99313,192553,4.3,12.7,60753,2.6,25.4,0,7068,7085,49787
2004,48,333499,439327,8030074,7951949,53806,12.4,43807,10.1,1377969,552369,825600,6.9,17.3,1221718,431467,790251,5.4,15.4,156251,1.9,30.8,0,29471,29559,215391
2004,49,43504,52689,941472,917082,7976,15.4,5685,11,175707,64177,111530,7,19.2,126927,44311,82616,4.8,13.8,48780,5.4,27.6,0,3661,3662,23687
2004,50,16846,19428,254486,254759,1910,9.9,1526,7.9,28484,10113,18371,4,11.2,29029,8621,20408,3.4,11.4,-545,-0.2,22.4,0,989,989,5101
2004,51,130500,167869,3012556,2946653,19757,12,13858,8.4,492342,169287,323055,5.7,16.7,360536,114356,246180,3.9,12.2,131806,4.5,24.4,0,8906,8925,59257
2004,53,121553,148614,2254645,2220614,18789,12.8,14670,10,357850,130621,227229,5.9,16.1,289788,92476,197312,4.2,13,68062,3.1,26,0,9700,9707,52073
2004,54,29277,36990,560839,555586,3608,9.8,3007,8.2,75100,23635,51465,4.3,13.5,64594,19465,45129,3.5,11.6,10506,1.9,23.2,0,2058,2076,11217
2004,55,102322,128176,2426790,2394019,12238,9.6,9919,7.8,328130,112091,216039,4.7,13.7,262588,84529,178059,3.5,11,65542,2.7,22,0,6469,6505,42359
2004,56,14522,16761,184508,180378,1974,11.9,1549,9.3,30645,10355,20290,5.7,17,22385,7568,14817,4.2,12.4,8260,4.6,24.8,0,998,998,4429
2005,01,71912,93111,1659449,1631579,10115,11,7823,8.5,273576,94471,179105,5.8,16.8,217836,64618,153218,4,13.4,55740,3.4,26.8,0,5581,5598,37789
2005,02,13471,16436,229750,226102,1989,12.3,1489,9.2,36130,11233,24897,5,16,28833,7284,21549,3.2,12.8,7297,3.2,25.6,0,954,954,4564
2005,04,88023,112792,2139013,2069130,16546,15,10455,9.5,422991,174605,248386,8.4,20.4,283225,96580,186645,4.7,13.7,139766,6.7,27.4,0,7203,7207,54239
2005,05,47064,59357,1012685,1001337,6640,11.3,5192,8.8,142304,52579,89725,5.3,14.2,119608,37751,81857,3.8,11.9,22696,2.3,23.8,0,3909,3915,24263
2005,06,605273,751942,13177145,13052191,101138,13.7,74499,10.1,2180408,854824,1325584,6.5,16.7,1930500,637404,1293096,4.9,14.8,249908,1.9,29.6,0,52690,52838,386688
2005,08,105962,128910,1916647,1892777,18113,14.3,13156,10.4,317822,131535,186287,6.9,16.8,270082,99581,170501,5.3,14.3,47740,2.5,28.6,0,8689,8721,60685
2005,09,68836,83631,1521703,1518199,8673,10.5,7104,8.6,212726,95135,117591,6.3,14,205718,75888,129830,5,13.6,7008,0.4,27.2,0,4581,4584,35113
2005,10,18337,22486,389048,387117,2507,11.2,2172,9.7,56395,20713,35682,5.4,14.6,52533,21993,30540,5.7,13.6,3862,1,27.2,0,1277,1280,9911
2005,11,15363,18966,444983,440088,2420,13.1,1399,7.6,58690,22051,36639,5,13.3,48900,12366,36534,2.8,11.1,9790,2.2,22.2,0,765,771,4963
2005,12,350111,430317,6716730,6580273,69028,16.4,45090,10.7,1308585,564985,743600,8.6,19.9,1035672,389267,646405,5.9,15.7,272913,4.2,31.4,0,31495,31606,245309
2005,13,151220,193210,3468852,3431017,25803,13.6,18319,9.6,562191,222054,340137,6.5,16.4,486520,163235,323285,4.8,14.2,75671,2.2,28.4,0,12446,12459,94906
2005,15,23342,29218,488012,479279,3022,10.5,2163,7.5,73629,29524,44105,6.2,15.4,56162,18263,37899,3.8,11.7,17467,3.7,23.4,0,1488,1513,11864
2005,16,31202,37008,512668,498015,5447,15.1,3256,9,94719,40162,54557,8.1,19,65412,25513,39899,5.1,13.1,29307,5.9,26.2,0,2211,2213,13245
2005,17,225231,280786,5226680,5206469,31443,11.3,24906,9,738829,281928,456901,5.4,14.2,698408,216830,481578,4.2,13.4,40421,0.8,26.8,0,15895,15939,119666
2005,18,104070,135432,2601718,2581586,13520,10,11318,8.4,355650,136039,219611,5.3,13.8,315387,95130,220257,3.7,12.2,40263,1.6,24.4,0,7695,7731,58069
2005,19,58095,73657,1252778,1240617,6891,9.4,5678,7.8,155052,51552,103500,4.2,12.5,130730,38837,91893,3.1,10.5,24322,2,21,0,3895,3915,23536
2005,20,54925,68722,1114776,1107069,7110,10.4,5647,8.3,156816,59516,97300,5.4,14.2,141402,49074,92328,4.4,12.8,15414,1.4,25.6,0,3950,3961,22931
2005,21,65155,83888,1507427,1494006,8675,10.4,6993,8.4,219240,76880,142360,5.1,14.7,192398,54583,137815,3.7,12.9,26842,1.8,25.8,0,4976,4997,34179
2005,22,74343,94119,1595567,1591094,9481,10.1,7988,8.5,247053,87349,159704,5.5,15.5,238107,81703,156404,5.1,15,8946,0.5,30,0,5661,5682,46805
2005,23,30029,36035,491066,487321,3942,11.1,3049,8.6,63531,23141,40390,4.7,13,56041,16363,39678,3.4,11.5,7490,1.5,23,0,2028,2030,10046
2005,24,98925,122494,2149555,2136365,14356,11.9,10671,8.8,311484,116536,194948,5.5,14.6,285104,92183,192921,4.3,13.3,26380,1.3,26.6,0,6888,6912,47335
2005,25,126867,156237,2984726,2965989,16184,10.4,14538,9.3,390506,142639,247867,4.8,13.2,353033,114721,238312,3.9,11.9,37473,1.3,23.8,0,9994,10016,59204
2005,26,166027,208880,3744556,3783823,21973,10.6,19009,9.1,509260,203619,305641,5.4,13.5,587794,163445,424349,4.3,15.5,-78534,-2,27,0,12432,12501,98464
2005,27,104632,129977,2427066,2396825,14093,11,10955,8.5,341646,129092,212554,5.4,14.3,281163,85388,195775,3.6,11.7,60483,2.6,23.4,0,7009,7015,46889
2005,28,43151,55247,921008,917686,5953,10.8,4977,9.1,130840,50186,80654,5.5,14.3,124196,38416,85780,4.2,13.5,6644,0.8,27,0,3568,3581,24395
2005,29,109890,138449,2403593,2392461,16834,12.3,12655,9.3,332003,134550,197453,5.6,13.9,309738,95285,214453,4,12.9,22265,1,25.8,0,9065,9077,62935
2005,30,26175,30376,321427,316337,3842,12.9,2657,8.9,48827,19764,29063,6.2,15.4,38646,11580,27066,3.7,12.2,10181,3.2,24.4,0,1817,1823,7710
2005,31,37553,46300,772314,769377,4504,9.8,3551,7.7,106507,35439,71068,4.6,13.8,100633,25254,75379,3.3,13.1,5874,0.7,26.2,0,2438,2448,15097
2005,32,39944,49397,1075671,1042919,8322,17.3,5386,11.2,208347,81571,126776,7.8,20,142842,61929,80913,5.9,13.7,65505,6.3,27.4,0,3865,3867,35349
2005,33,28956,34769,548640,541897,3939,11.5,3045,8.9,73855,30351,43504,5.6,13.6,60369,20028,40341,3.7,11.1,13486,2.5,22.2,0,2140,2141,13077
2005,34,180091,212238,3552113,3553499,25604,12.2,21021,10,515318,197025,318293,5.5,14.5,518089,181626,336463,5.1,14.6,-2771,-0.1,29,0,14356,14368,95454
2005,35,32438,40056,590270,581465,4672,11.8,3492,8.8,98846,35146,63700,6,17,81236,24115,57121,4.1,14,17610,3,28,0,2396,2406,15245
2005,36,384163,451631,7403069,7375824,53326,11.9,45516,10.1,1062462,422126,640336,5.7,14.4,1007972,340100,667872,4.6,13.7,54490,0.7,27.4,0,30952,30992,197576
2005,37,151442,193993,3400922,3359538,23281,12.2,16842,8.8,534166,211759,322407,6.3,15.9,451397,135521,315876,4,13.4,82769,2.5,26.8,0,11606,11645,77305
2005,38,15462,18736,269393,265229,1820,9.8,1393,7.5,37081,13826,23255,5.2,14,28753,10192,18561,3.8,10.8,8328,3.2,21.6,0,913,913,4456
2005,39,186389,246001,4744929,4726960,23518,9.6,20405,8.3,665589,248028,417561,5.2,14.1,629650,193220,436430,4.1,13.3,35939,0.8,26.6,0,13457,13490,108152
2005,40,63843,79697,1205678,1192297,9062,11.5,6982,8.9,186691,74331,112360,6.2,15.7,159928,57444,102484,4.8,13.4,26763,2.3,26.8,0,5008,5017,35698
2005,41,78290,95360,1402399,1369622,12411,13.3,8535,9.1,224807,89629,135178,6.5,16.4,159253,56929,102324,4.2,11.6,65554,4.8,23.2,0,5748,5753,34001
2005,42,215632,275372,5070892,5062801,27814,10.2,22469,8.2,672047,260419,411628,5.1,13.3,655866,215377,440489,4.3,13,16181,0.3,26,0,14870,14917,110175
2005,44,23166,26675,436274,433121,2917,11,2399,9.1,55690,21819,33871,5,12.9,49383,14857,34526,3.4,11.4,6307,1.5,22.8,0,1624,1624,9942
2005,45,72961,93164,1573762,1551434,11257,12.3,7976,8.7,241090,94590,146500,6.1,15.5,196434,57262,139172,3.7,12.7,44656,2.8,25.4,0,5710,5723,35455
2005,46,18890,22338,307994,304208,2371,10.7,1802,8.2,41807,13486,28321,4.4,13.7,34234,10468,23766,3.4,11.3,7573,2.4,22.6,0,1217,1217,5730
2005,47,92051,121869,2364418,2341395,13659,11.3,10705,8.9,354928,126515,228413,5.4,15.2,308884,93180,215704,4,13.2,46044,2,26.4,0,7507,7520,53794
2005,48,339128,448680,8215506,8097394,56076,12.7,42154,9.5,1406982,582885,824097,7.2,17.4,1170757,393096,777661,4.9,14.5,236225,2.9,29,0,29533,29652,239955
2005,49,45597,55091,972918,954056,8635,16.1,5716,10.6,179922,67925,111997,7.1,18.9,142198,49560,92638,5.2,14.9,37724,4,29.8,0,3773,3783,28465
2005,50,16982,19618,260216,256746,1923,9.9,1617,8.3,35535,11602,23933,4.5,13.8,28595,9684,18911,3.8,11.1,6940,2.7,22.2,0,1093,1096,6060
2005,51,134080,172304,3045105,3018187,20636,12.2,14589,8.6,458002,176325,281677,5.8,15.2,404166,112578,291588,3.7,13.4,53836,1.8,26.8,0,9668,9719,57677
2005,53,125549,153434,2310036,2275844,20816,13.8,14657,9.7,371159,141270,229889,6.2,16.3,302774,106893,195881,4.7,13.3,68385,3,26.6,0,9939,9944,60143
2005,54,29409,37336,563488,561025,3867,10.4,3194,8.6,77227,27024,50203,4.8,13.8,72300,21045,51255,3.8,12.9,4927,0.9,25.8,0,2213,2217,11307
2005,55,103727,130102,2446067,2430833,12905,10,10086,7.8,317952,110272,207680,4.5,13.1,287484,89045,198439,3.7,11.8,30468,1.3,23.6,0,6877,6916,48367
2005,56,14928,17291,189283,187032,2173,12.8,1520,8.9,30516,11353,19163,6.1,16.3,26014,7963,18051,4.3,13.9,4502,2.4,27.8,0,1067,1067,5437
2006,01,71954,94127,1701773,1676746,10453,11.2,8535,9.1,272608,108950,163658,6.5,16.3,222554,80075,142479,4.8,13.3,50054,3,26.6,0,5906,5931,42249
2006,02,13514,16695,238962,233553,2145,13,1738,10.5,41404,12061,29343,5.2,17.7,30586,10343,20243,4.4,13.1,10818,4.6,26.2,0,1069,1069,5605
2006,04,92344,119297,2315790,2222118,18941,16.4,11445,9.9,457057,179957,277100,8.1,20.6,269712,92587,177125,4.2,12.1,187345,8.5,24.2,0,7755,7780,54014
2006,05,47017,60099,1041471,1024168,7008,11.8,5708,9.6,150865,58025,92840,5.7,14.7,116259,37532,78727,3.7,11.4,34606,3.3,22.8,0,4114,4130,25150
2006,06,617167,770688,13670822,13386120,104928,13.8,79912,10.5,2394590,921350,1473240,6.9,17.9,1825187,640102,1185085,4.8,13.6,569403,4.3,27.2,0,55919,56079,397172
2006,08,107962,131989,1996575,1950075,18625,14.3,14228,10.9,352865,142727,210138,7.3,18.1,259864,98185,161679,5,13.3,93001,4.8,26.6,0,9292,9310,60508
2006,09,68481,83902,1548385,1531126,8612,10.3,7724,9.2,210657,76552,134105,5,13.8,176138,59798,116340,3.9,11.5,34519,2.3,23,0,5304,5306,35642
2006,10,18167,22422,382238,384702,2553,11.4,2412,10.8,56305,21131,35174,5.5,14.6,61233,24686,36547,6.4,15.9,-4928,-1.3,29.2,0,1493,1509,9499
2006,11,15582,19355,450719,446359,2091,10.9,1527,8,66071,20219,45852,4.5,14.8,57350,14988,42362,3.4,12.8,8721,2,25.6,0,883,889,7106
2006,12,360894,444343,7115942,6902110,67750,15.5,49324,11.3,1351833,510172,841661,7.4,19.6,924170,357783,566387,5.2,13.4,427663,6.2,26.8,0,34326,34386,217924
2006,13,154619,198160,3602323,3525491,26474,13.6,19790,10.1,620564,247547,373017,7,17.6,466899,174351,292548,4.9,13.2,153665,4.4,26.4,0,13152,13168,98618
2006,15,23743,30034,510424,498357,3293,11.1,2258,7.6,77896,29064,48832,5.8,15.6,53762,17791,35971,3.6,10.8,24134,4.8,21.6,0,1540,1540,10434
2006,16,32972,39067,542836,526510,6128,16.1,3879,10.2,98769,37401,61368,7.1,18.8,66116,27317,38799,5.2,12.6,32653,6.2,25.2,0,2571,2573,18990
2006,17,226308,283645,5343846,5273257,31767,11.3,26528,9.4,808531,297894,510637,5.6,15.3,667353,246879,420474,4.7,12.7,141178,2.6,25.4,0,16825,16856,133372
2006,18,104308,136925,2662114,2626291,14591,10.7,12079,8.9,384097,141904,242193,5.4,14.6,312451,102604,209847,3.9,11.9,71646,2.7,23.8,0,7765,7798,60653
2006,19,57538,74149,1288004,1268988,7748,10.5,6623,9,171931,65542,106389,5.2,13.5,133898,42444,91454,3.3,10.6,38033,2.9,21.2,0,4109,4109,27432
2006,20,54519,68823,1133017,1120068,7293,10.6,6604,9.6,160727,58763,101964,5.2,14.3,134828,45358,89470,4,12,25899,2.3,24,0,4233,4256,26678
2006,21,65039,84574,1535869,1515778,8851,10.5,7512,8.9,226016,81378,144638,5.4,14.9,185833,64945,120888,4.3,12.3,40183,2.6,24.6,0,5190,5194,41128
2006,22,70851,90863,1566764,1572744,9927,10.8,11567,12.5,274594,99278,175316,6.3,17.5,286553,95426,191127,6.1,18.2,-11959,-0.7,35,0,7253,7259,51744
2006,23,30147,36448,499695,493834,4229,11.7,3533,9.8,69811,29962,39849,6.1,14.1,58088,21713,36375,4.4,11.8,11723,2.3,23.6,0,2417,2422,14079
2006,24,100089,124696,2218117,2179281,14684,11.9,11418,9.3,349989,127905,222084,5.9,16.1,272319,97711,174608,4.5,12.5,77670,3.6,25,0,7530,7547,51587
2006,25,127517,157968,3053940,3012055,16948,10.8,13974,8.9,448565,167204,281361,5.6,14.9,364796,122447,242349,4.1,12.1,83769,2.8,24.2,0,9313,9320,66825
2006,26,164697,209042,3772073,3746234,21887,10.5,20103,9.6,547779,197310,350469,5.3,14.6,496101,155837,340264,4.2,13.2,51678,1.4,26.4,0,13450,13486,91161
2006,27,105141,131841,2478294,2446297,15152,11.6,12127,9.3,357491,130076,227415,5.3,14.6,293498,101618,191880,4.2,12,63993,2.6,24,0,7604,7613,56714
2006,28,42378,54740,935417,925700,6072,11.1,5920,10.8,146660,56744,89916,6.1,15.8,127225,42164,85061,4.6,13.7,19435,2.1,27.4,0,3932,3937,25709
2006,29,108081,138051,2443243,2416727,16145,11.7,15286,11.1,362704,139368,223336,5.8,15,309671,108230,201441,4.5,12.8,53033,2.2,25.6,0,10613,10657,63802
2006,30,27004,31409,337702,328718,4337,14.1,3079,10,60311,25660,34651,7.8,18.3,42342,16718,25624,5.1,12.9,17969,5.4,25.8,0,2009,2009,11297
2006,31,37422,46581,788799,778278,4789,10.3,4168,9,107898,42467,65431,5.5,13.9,86857,27124,59733,3.5,11.2,21041,2.7,22.4,0,2589,2596,16806
2006,32,41777,52023,1156247,1113346,8910,17.6,5851,11.6,230161,93095,137066,8.4,20.7,144358,52060,92298,4.7,13,85803,7.7,26,0,4160,4163,33483
2006,33,28965,35037,562756,554098,3952,11.3,3388,9.7,85932,32360,53572,5.8,15.5,68616,24186,44430,4.4,12.4,17316,3.1,24.8,0,2342,2343,14464
2006,34,180875,214051,3603011,3566348,25502,12,21916,10.3,552578,209624,342954,5.9,15.5,479252,166471,312781,4.7,13.4,73326,2.1,26.8,0,15420,15434,89555
2006,35,32912,40842,621952,604139,5040,12.5,3898,9.7,111325,41252,70073,6.8,18.4,75699,29401,46298,4.9,12.5,35626,5.9,25,0,2614,2619,18882
2006,36,384889,455004,7496532,7431798,53955,11.9,47184,10.4,1087447,400454,686993,5.4,14.6,957979,341595,616384,4.6,12.9,129468,1.7,25.8,0,34251,34297,219234
2006,37,153588,198335,3517689,3448872,24326,12.4,18257,9.3,571959,222664,349295,6.5,16.6,434325,153612,280713,4.5,12.6,137634,4,25.2,0,12490,12513,86009
2006,38,15382,18823,277225,272642,1947,10.4,1674,8.9,38946,13915,25031,5.1,14.3,29781,10768,19013,3.9,10.9,9165,3.4,21.8,0,1000,1000,6550
2006,39,184406,245668,4799607,4756346,24058,9.8,22182,9,679334,254924,424410,5.4,14.3,592812,208215,384597,4.4,12.5,86522,1.8,25,0,14293,14372,113689
2006,40,64105,80532,1274291,1234952,9227,11.5,7578,9.5,226015,91281,134734,7.4,18.3,147338,54588,92750,4.4,11.9,78677,6.4,23.8,0,5167,5197,32379
2006,41,79765,97777,1451026,1423618,12706,13.2,9432,9.8,232214,86580,145634,6.1,16.3,177397,63190,114207,4.4,12.5,54817,3.8,25,0,6508,6508,42900
2006,42,214383,276494,5154256,5099144,27512,10,24024,8.7,701914,265615,436299,5.2,13.8,591690,209206,382484,4.1,11.6,110224,2.2,23.2,0,16148,16321,130080
2006,44,23301,26983,436764,435260,3077,11.5,2542,9.5,60815,23511,37304,5.4,14,57806,16988,40818,3.9,13.3,3009,0.7,26.6,0,1724,1729,9423
2006,45,73888,94865,1624150,1594154,11278,12,8772,9.4,254887,97591,157296,6.1,16,194895,66010,128885,4.1,12.2,59992,3.8,24.4,0,6003,6013,40476
2006,46,18911,22459,319013,312906,2472,11.1,2169,9.7,45412,16249,29163,5.2,14.5,33197,11549,21648,3.7,10.6,12215,3.9,21.2,0,1366,1367,7775
2006,47,92440,123358,2461294,2406681,14215,11.6,11590,9.5,390448,147819,242629,6.1,16.2,281222,93568,187654,3.9,11.7,109226,4.5,23.4,0,7645,7672,50756
2006,48,342461,457285,8583459,8369291,57906,12.8,44996,10,1538781,585359,953422,7,18.4,1110446,408115,702331,4.9,13.3,428335,5.1,26.6,0,30260,30359,233183
2006,49,47950,58046,1034297,1001326,9500,16.8,6005,10.6,190759,73634,117125,7.4,19.1,124817,46827,77990,4.7,12.5,65942,6.6,25,0,4045,4087,28691
2006,50,16957,19687,262007,260639,1975,10.1,1781,9.1,31767,10922,20845,4.2,12.2,29030,9439,19591,3.6,11.1,2737,1.1,22.2,0,1214,1220,6471
2006,51,136452,176674,3152167,3086766,21841,12.5,15869,9.1,514542,185777,328765,6,16.7,383741,126983,256758,4.1,12.4,130801,4.3,24.8,0,10672,10686,68733
2006,53,128042,157132,2401204,2349985,21238,13.7,16209,10.5,406130,147470,258660,6.3,17.3,303691,103112,200579,4.4,12.9,102439,4.4,25.8,0,10929,10934,64051
2006,54,28947,37112,579566,570120,3705,10,3567,9.6,87247,32759,54488,5.7,15.3,68355,23246,45109,4.1,12,18892,3.3,24,0,2350,2357,13822
2006,55,103092,130620,2469010,2450218,13345,10.3,11745,9,323959,119501,204458,4.9,13.2,286374,88864,197510,3.6,11.7,37585,1.5,23.4,0,7666,7672,55493
2006,56,15210,17627,201947,195009,2279,13.1,1783,10.2,37493,14712,22781,7.5,19.2,23617,9023,14594,4.6,12.1,13876,7.1,24.2,0,1162,1166,6251
2007,01,73242,96526,1718169,1706364,11089,11.6,8667,9.1,275269,102861,172408,6,16.1,251659,80887,170772,4.7,14.7,23610,1.4,29.4,0,5596,5685,37094
2007,02,13656,16934,241920,240306,2033,12.1,1837,10.9,44247,15457,28790,6.4,18.4,41019,11038,29981,4.6,17.1,3228,1.3,34.2,0,1028,1039,4935
2007,04,95367,123760,2374464,2340144,18072,14.9,13330,11,468513,165632,302881,7.1,20,399872,132846,267026,5.7,17.1,68641,2.9,34.2,0,8323,8391,63389
2007,05,47399,61033,1030380,1033247,6730,11.1,5641,9.3,151549,55680,95869,5.4,14.7,157285,46143,111142,4.5,15.2,-5736,-0.5,29.4,0,3791,3811,22436
2007,06,627092,783091,13708164,13659650,101437,13.1,86040,11.1,2311674,837847,1473827,6.1,16.9,2214646,745596,1469050,5.5,16.2,97028,0.7,32.4,0,54998,55593,355710
2007,08,110326,135328,2040170,2012974,18667,14,14993,11.2,374177,147975,226202,7.4,18.6,319786,112071,207715,5.6,15.9,54391,2.7,31.8,0,9137,9200,56408
2007,09,68225,84190,1537164,1540987,8369,10,7863,9.4,225937,83115,142822,5.4,14.7,233583,65267,168316,4.2,15.2,-7646,-0.5,29.4,0,4892,4944,30111
2007,10,18036,22635,382750,381877,2694,12,2422,10.8,68971,31164,37807,8.2,18.1,67224,25229,41995,6.6,17.6,1747,0.5,35.2,0,1393,1395,9682
2007,11,15704,19667,466746,458077,2141,11,1779,9.1,75866,23757,52109,5.2,16.6,58529,19376,39153,4.2,12.8,17337,3.8,25.6,0,935,939,7362
2007,12,365813,452973,7088593,7087465,65417,14.6,55431,12.4,1265013,510170,754843,7.2,17.8,1262758,451871,810887,6.4,17.8,2255,0,35.6,0,37329,37612,211527
2007,13,158478,203958,3645732,3616624,27198,13.5,20972,10.4,615938,234317,381621,6.5,17,557722,185712,372010,5.1,15.4,58216,1.6,30.8,0,13325,13539,87990
2007,15,24062,30378,517250,512997,3176,10.5,2804,9.3,81709,27973,53736,5.5,15.9,73202,29370,43832,5.7,14.3,8507,1.6,28.6,0,1636,1657,14245
2007,16,34460,40908,546137,543932,6021,15.1,4147,10.4,100251,39109,61142,7.2,18.4,95840,30962,64878,5.7,17.6,4411,0.8,35.2,0,2728,2741,18595
2007,17,228146,287053,5362034,5345845,31264,11,27332,9.6,814143,280871,533272,5.3,15.2,781764,251007,530757,4.7,14.6,32379,0.6,29.2,0,16305,16473,118854
2007,18,104775,138369,2642023,2645792,14395,10.5,12725,9.3,391034,136204,254830,5.1,14.8,398573,120018,278555,4.5,15.1,-7539,-0.3,29.6,0,7852,7954,55931
2007,19,57836,74693,1291366,1288325,6890,9.3,6283,8.5,171152,54137,117015,4.2,13.3,165070,49728,115342,3.9,12.8,6082,0.5,25.6,0,3791,3833,23021
2007,20,54909,69528,1149234,1137885,7297,10.6,6490,9.4,173681,67231,106450,5.9,15.3,150982,48195,102787,4.2,13.3,22699,2,26.6,0,4003,4045,24045
2007,21,65233,85368,1539949,1534537,8789,10.4,7737,9.1,235190,87436,147754,5.7,15.3,224365,63467,160898,4.1,14.6,10825,0.7,29.2,0,4947,4997,33849
2007,22,74096,94831,1631566,1596659,11565,12.5,7861,8.5,298449,101143,197306,6.3,18.7,228635,67152,161483,4.2,14.3,69814,4.4,28.6,0,4881,4930,34515
2007,23,30297,36884,497712,497728,4064,11.1,3607,9.8,73304,28961,44343,5.8,14.7,73336,26967,46369,5.4,14.7,-32,0,29.4,0,2216,2225,13935
2007,24,100821,126012,2213249,2211202,14143,11.3,12484,10,337614,120251,217363,5.4,15.3,333520,104321,229199,4.7,15.1,4094,0.2,30.2,0,7541,7604,47227
2007,25,127388,158399,3067534,3059532,15895,10.1,15206,9.6,429956,132276,297680,4.3,14.1,413952,128192,285760,4.2,13.5,16004,0.6,27,0,9079,9189,54890
2007,26,163318,208325,3663431,3707476,21334,10.2,21593,10.4,521513,188692,332821,5.1,14.1,609602,203336,406266,5.5,16.4,-88089,-2.3,28.2,0,13324,13556,87461
2007,27,105321,132381,2531159,2499732,14128,10.7,13300,10.1,396078,135793,260285,5.4,15.8,333225,110322,222903,4.4,13.3,62853,2.5,26.6,0,7473,7528,50542
2007,28,43366,56272,935527,934203,6511,11.7,5085,9.2,139243,47866,91377,5.1,14.9,136595,40660,95935,4.4,14.6,2648,0.3,29.2,0,3320,3343,18920
2007,29,108071,139117,2457125,2445373,15513,11.2,14104,10.2,365319,127368,237951,5.2,14.9,341815,104523,237292,4.3,14,23504,0.9,28,0,9267,9383,52352
2007,30,27856,32425,351307,344261,4113,12.9,3045,9.5,62508,22043,40465,6.4,18.2,48415,15666,32749,4.6,14.1,14093,4.1,28.2,0,1931,1954,9126
2007,31,37642,47102,793785,789475,4667,10,4077,8.7,110862,37584,73278,4.8,14,102243,29662,72581,3.8,13,8619,1,26,0,2492,2500,15152
2007,32,43089,54021,1189359,1167862,8770,16.6,6645,12.5,236182,92579,143603,7.9,20.2,193188,60911,132277,5.2,16.5,42994,3.7,33,0,4383,4406,30457
2007,33,28918,35212,563685,562318,3770,10.7,3484,9.9,79736,26782,52954,4.8,14.2,77001,22783,54218,4.1,13.7,2735,0.5,27.4,0,2233,2244,13035
2007,34,180965,214977,3626806,3610285,24482,11.4,23253,10.9,568653,204154,364499,5.7,15.8,535613,176524,359089,4.9,14.8,33040,1,29.6,0,15300,15366,84378
2007,35,33451,41765,639555,630024,4908,11.9,3935,9.5,115614,49000,66614,7.8,18.4,96551,28392,68159,4.5,15.3,19063,3.1,30.6,0,2469,2491,14656
2007,36,387203,458493,7520700,7499186,52189,11.4,47542,10.4,1118384,399094,719290,5.3,14.9,1075357,379960,695397,5.1,14.3,43027,0.6,28.6,0,31816,32022,183250
2007,37,157050,203768,3576955,3539610,25057,12.5,19291,9.6,589353,214550,374803,6.1,16.7,514663,164685,349978,4.7,14.5,74690,2.2,29,0,12116,12278,79195
2007,38,15645,19170,287924,283220,1923,10.1,1603,8.4,45878,17774,28104,6.3,16.2,36470,11507,24963,4.1,12.9,9408,3.3,25.8,0,912,923,6852
2007,39,182916,245813,4774526,4776490,23946,9.8,23300,9.5,678503,248663,429840,5.2,14.2,682431,210758,471673,4.4,14.3,-3928,-0.1,28.4,0,13776,14011,99005
2007,40,65032,82232,1296940,1282434,9383,11.5,7571,9.3,221517,77023,144494,6,17.3,192505,61668,130837,4.8,15,29012,2.3,30,0,4940,4986,32392
2007,41,81717,100301,1471424,1458850,12340,12.5,9682,9.8,229540,81241,148299,5.6,15.7,204392,65546,138846,4.5,14,25148,1.7,28,0,6164,6235,33884
2007,42,214521,277520,5189366,5161012,27097,9.8,24983,9,736583,252168,484415,4.9,14.3,679875,219194,460681,4.2,13.2,56708,1.1,26.4,0,14727,14926,91845
2007,44,23132,26964,441321,438139,2734,10.1,2715,10.1,62334,20693,41641,4.7,14.2,55969,17631,38338,4,12.8,6365,1.4,25.6,0,1748,1763,10314
2007,45,75140,97362,1639777,1626298,11744,12.2,9114,9.5,271253,103032,168221,6.3,16.7,244295,75528,168767,4.6,15,26958,1.7,30,0,6035,6123,38306
2007,46,19196,22911,324515,321366,2471,10.9,1994,8.8,48058,17987,30071,5.6,15,41759,14128,27631,4.4,13,6299,2,26,0,1229,1233,7420
2007,47,93687,125759,2488022,2470788,14394,11.6,11806,9.5,411248,137346,273902,5.6,16.6,376782,117044,259738,4.7,15.2,34466,1.4,30.4,0,7401,7498,50216
2007,48,349591,469229,8908600,8726014,60291,13,46691,10.1,1698407,635983,1062424,7.3,19.5,1333234,469560,863674,5.4,15.3,365173,4.2,30.6,0,29483,29838,219750
2007,49,50829,61337,1086360,1057626,9676,16.2,6319,10.6,206594,70275,136319,6.6,19.5,149125,51916,97209,4.9,14.1,57469,5.4,28.2,0,4008,4026,26435
2007,50,17094,19849,270811,266249,2029,10.3,1861,9.4,42089,13145,28944,4.9,15.8,32967,10705,22262,4,12.4,9122,3.4,24.8,0,1088,1096,5047
2007,51,138162,179877,3152240,3145819,21084,11.8,17544,9.9,516310,173876,342434,5.5,16.4,503470,157480,345990,5,16,12840,0.4,32,0,10590,10701,69289
2007,53,131402,161294,2486022,2439719,21222,13.3,16810,10.6,428221,145357,282864,6,17.6,335615,119696,215919,4.9,13.8,92606,3.8,27.6,0,10561,10630,57595
2007,54,28886,37304,578269,578025,3600,9.7,3416,9.2,85671,32272,53399,5.6,14.8,85184,25866,59318,4.5,14.7,487,0.1,29.4,0,2163,2202,14133
2007,55,103199,131286,2479214,2470623,12957,9.9,11947,9.1,326968,111864,215104,4.5,13.2,309785,90916,218869,3.7,12.5,17183,0.7,25,0,7085,7162,44412
2007,56,15690,18238,209979,205331,2331,13,1691,9.4,38280,12920,25360,6.3,18.6,28983,10329,18654,5,14.1,9297,4.5,28.2,0,1102,1110,5347
2008,01,72666,96133,1710279,1706236,8962,9.3,8375,8.7,235717,78618,157099,4.6,13.8,227632,72377,155255,4.2,13.3,8085,0.5,26.6,0,6228,6235,40904
2008,02,13600,16897,245846,243073,1859,11,1731,10.3,35942,11169,24773,4.6,14.8,30396,7369,23027,3,12.5,5546,2.3,25,0,1055,1056,5020
2008,04,94692,123829,2303712,2329160,15715,12.7,14298,11.6,357479,143226,214253,6.1,15.3,408375,114421,293954,4.9,17.5,-50896,-2.2,30.6,0,10222,10249,71871
2008,05,46963,60728,1022808,1022270,5688,9.4,5412,8.9,127533,44767,82766,4.4,12.5,126458,33530,92928,3.3,12.4,1075,0.1,24.8,0,3979,3989,22908
2008,06,623470,781622,13659276,13636472,89808,11.5,83640,10.7,2093275,760834,1332441,5.6,15.4,2047666,649961,1397705,4.8,15,45609,0.4,30,0,59625,59738,415529
2008,08,110706,136128,2076050,2051948,16802,12.4,14839,11,339251,123614,215637,6,16.5,291047,98674,192373,4.8,14.2,48204,2.3,28.4,0,9818,9833,57149
2008,09,67748,84082,1554309,1540645,7693,9.2,7214,8.6,232065,83030,149035,5.4,15.1,204736,55547,149189,3.6,13.3,27329,1.8,26.6,0,4936,4937,31159
2008,10,17863,22492,386216,383273,2320,10.3,2255,10,60650,21986,38664,5.7,15.8,54763,13235,41528,3.5,14.3,5887,1.5,28.6,0,1536,1536,7615
2008,11,15692,19763,475091,469428,1968,10,1584,8.1,62801,20445,42356,4.4,13.4,51475,14915,36560,3.2,11,11326,2.4,22,0,917,918,5406
2008,12,356383,444842,6955452,6996652,55755,12.5,59285,13.3,1081060,436135,644925,6.2,15.5,1163460,372201,791259,5.3,16.6,-82400,-1.1,31,0,43639,43737,238360
2008,13,157375,203885,3620476,3617140,24133,11.9,22238,11,573344,229777,343567,6.4,15.9,566671,197189,369482,5.5,15.7,6673,0.2,31.4,0,15827,15838,102339
2008,15,23717,30128,514531,513837,2689,8.9,2602,8.6,65104,22223,42881,4.3,12.7,63716,17302,46414,3.4,12.4,1388,0.3,24.8,0,1847,1849,11532
2008,16,33945,40649,535489,539087,4850,11.9,4694,11.5,75885,29055,46830,5.4,14.1,83081,26370,56711,4.9,15.4,-7196,-1.3,28.2,0,3318,3333,19039
2008,17,226514,286653,5445625,5384046,28500,10,26448,9.3,784177,262969,521208,4.9,14.6,661019,192868,468151,3.6,12.3,123158,2.3,24.6,0,17559,17584,110403
2008,18,103458,137213,2610538,2615628,12301,9,11995,8.7,333708,109637,224071,4.2,12.8,343888,99837,244051,3.8,13.1,-10180,-0.3,25.6,0,8371,8374,60064
2008,19,57371,74301,1305352,1294321,6104,8.2,5908,8,162730,46812,115918,3.6,12.6,140667,39818,100849,3.1,10.9,22063,1.7,21.8,0,3945,3948,22999
2008,20,54540,69315,1164818,1153430,6320,9.1,5826,8.4,155448,47419,108029,4.1,13.5,132671,39231,93440,3.4,11.5,22777,2,23,0,4079,4083,25341
2008,21,64390,84928,1553323,1541639,7540,8.9,7314,8.6,223130,85768,137362,5.6,14.5,199761,58822,140939,3.8,13,23369,1.5,26,0,5245,5260,39214
2008,22,74463,95650,1639290,1629772,9297,9.8,7724,8.1,239231,78226,161005,4.8,14.7,220196,61483,158713,3.8,13.5,19035,1.2,27,0,5604,5607,40881
2008,23,29818,36453,501096,498135,3469,9.5,3577,9.8,64704,20837,43867,4.2,13,58782,19474,39308,3.9,11.8,5922,1.2,23.6,0,2362,2363,12756
2008,24,99512,124979,2216349,2208003,12209,9.8,12017,9.6,313126,105259,207867,4.8,14.2,296434,96296,200138,4.4,13.4,16692,0.8,26.8,0,8261,8267,51635
2008,25,125940,157417,3069439,3059151,14093,9,13769,8.8,394435,130541,263894,4.3,12.9,373859,107873,265986,3.5,12.2,20576,0.7,24.4,0,9361,9362,57170
2008,26,159766,205229,3614936,3625301,18970,9.2,20189,9.8,509116,180795,328321,5,14,529846,171559,358287,4.7,14.6,-20730,-0.6,28,0,13996,14031,113506
2008,27,103933,131288,2516747,2517548,12347,9.4,12170,9.3,326381,115541,210840,4.6,13,327983,89085,238898,3.5,13,-1602,0,26,0,7894,7896,54139
2008,28,43035,56200,941160,935607,5366,9.6,4946,8.8,129829,42641,87188,4.6,13.9,118723,36648,82075,3.9,12.7,11106,1.2,25.4,0,3767,3768,23111
2008,29,106720,138276,2468080,2452162,13371,9.7,12982,9.4,342140,121905,220235,5,14,310304,84171,226133,3.4,12.7,31836,1.3,25.4,0,9328,9336,51347
2008,30,27792,32458,356555,352849,3505,10.8,3180,9.8,52324,17364,34960,4.9,14.8,44912,14716,30196,4.2,12.7,7412,2.1,25.4,0,2150,2152,10279
2008,31,37467,47090,798228,794079,4118,8.8,3765,8,104744,32907,71837,4.1,13.2,96446,24323,72123,3.1,12.1,8298,1.1,24.2,0,2513,2513,13956
2008,32,42952,54299,1152991,1166838,7673,14.2,6837,12.7,177997,73980,104017,6.3,15.3,205691,56422,149269,4.8,17.6,-27694,-2.3,30.6,0,5140,5147,35134
2008,33,28565,34921,581231,570408,3251,9.3,3272,9.4,91029,28588,62441,5,16,69382,19002,50380,3.3,12.2,21647,3.8,24.4,0,2285,2286,12191
2008,34,178769,213286,3613021,3611772,21852,10.2,22223,10.4,513989,190173,323816,5.3,14.2,511491,157381,354110,4.4,14.2,2498,0,28.4,0,16075,16089,92558
2008,35,33434,41824,638447,635396,4388,10.5,3974,9.5,95071,35380,59691,5.6,15,88969,25971,62998,4.1,14,6102,1,28,0,2740,2741,16765
2008,36,389295,461798,7625387,7554581,49839,10.9,43955,9.6,1087029,389779,697250,5.2,14.4,945418,304836,640582,4,12.5,141611,1.9,25,0,31791,31836,196343
2008,37,156461,204333,3582844,3564766,21338,10.5,18713,9.2,508264,182847,325417,5.1,14.3,472108,137177,334931,3.8,13.2,36156,1.1,26.4,0,13506,13531,84991
2008,38,15704,19275,293487,290123,1684,8.8,1401,7.3,39028,11143,27885,3.8,13.5,32301,8681,23620,3,11.1,6727,2.4,22.2,0,929,931,6858
2008,39,179209,241853,4715293,4729480,19929,8.2,21412,8.8,600579,206401,394178,4.4,12.7,628953,197547,431406,4.2,13.3,-28374,-0.6,25.4,0,14400,14429,106697
2008,40,65276,82984,1318490,1303599,8511,10.3,7157,8.7,198065,69189,128876,5.3,15.2,168283,48119,120164,3.7,12.9,29782,2.3,25.8,0,5183,5192,30666
2008,41,81599,100461,1473268,1467173,10823,10.8,9755,9.8,201822,68135,133687,4.6,13.8,189631,56030,133601,3.8,12.9,12191,0.9,25.8,0,6938,6940,37828
2008,42,213176,277621,5231863,5192051,24575,8.9,21951,7.9,680098,225487,454611,4.3,13.1,600475,170381,430094,3.3,11.6,79623,1.5,23.2,0,15121,15138,99893
2008,44,22775,26583,435594,437349,2443,9.1,2692,10.1,54657,21238,33419,4.9,12.5,58166,15894,42272,3.6,13.3,-3509,-0.8,25,0,1775,1777,9430
2008,45,74452,97154,1646369,1636862,9699,10,8945,9.2,235133,76753,158380,4.7,14.4,216118,57984,158134,3.5,13.2,19015,1.2,26.4,0,6506,6510,37788
2008,46,19153,22996,331735,326294,2185,9.5,1916,8.4,46032,15576,30456,4.8,14.1,35150,11506,23644,3.5,10.8,10882,3.3,21.6,0,1360,1364,7540
2008,47,93094,126432,2485231,2478082,13042,10.4,11156,8.9,362698,131254,231444,5.3,14.6,348400,89861,258539,3.6,14.1,14298,0.5,28.2,0,8262,8274,59292
2008,48,352462,474307,9083810,8960271,53790,11.5,43439,9.3,1528537,564321,964216,6.3,17.1,1281461,391237,890224,4.4,14.3,247076,2.8,28.6,0,31198,31288,233904
2008,49,51292,61940,1099944,1089904,8111,13.2,7035,11.4,180356,56715,123641,5.2,16.5,160276,53734,106542,4.9,14.7,20080,1.8,29.4,0,4919,4921,32742
2008,50,16857,19608,272574,270929,1724,8.8,1801,9.2,32871,11833,21038,4.4,12.1,29581,9336,20245,3.4,10.9,3290,1.2,21.8,0,1167,1167,6398
2008,51,137392,179167,3144965,3138202,18346,10.3,17198,9.6,457482,154088,303394,4.9,14.6,443956,129704,314252,4.1,14.1,13526,0.5,28.2,0,11719,11747,64120
2008,53,131990,162537,2510431,2490976,18980,11.8,16293,10.1,361250,116939,244311,4.7,14.5,322339,101205,221134,4.1,12.9,38911,1.6,25.8,0,11414,11417,64943
2008,54,28335,36906,579591,576985,2942,8,3115,8.4,75150,22237,52913,3.9,13,69938,18945,50993,3.3,12.1,5212,0.9,24.2,0,2296,2296,11841
2008,55,101772,130290,2486003,2476303,11023,8.5,11024,8.5,292680,92929,199751,3.8,11.8,273279,78924,194355,3.2,11,19401,0.8,22,0,7453,7504,48839
2008,56,15787,18368,217027,212960,2065,11.3,1786,9.8,38167,13141,25026,6.2,17.9,30032,9552,20480,4.5,14.1,8135,3.8,28.2,0,1183,1184,5696
2009,01,70162,93377,1603698,1649880,7519,8,9425,10,175023,65304,109719,4,10.6,267387,65259,202128,4,16.2,-92364,-5.6,21.2,0,6704,6723,36116
2009,02,13338,16708,249014,246886,1716,10.2,1793,10.7,39328,12482,26846,5.1,15.9,35072,10636,24436,4.3,14.2,4256,1.7,28.4,0,1019,1039,5174
2009,04,89209,117975,2094631,2190657,12483,10.4,16725,13.9,271284,114252,157032,5.2,12.4,463336,148847,314489,6.8,21.2,-192052,-8.8,24.8,0,11454,11496,68743
2009,05,45818,59583,967448,992135,5128,8.6,5798,9.7,107583,41703,65880,4.2,10.8,156958,42965,113993,4.3,15.8,-49375,-5,21.6,0,4122,4134,23510
2009,06,603592,760096,12756655,13152313,77068,10,90213,11.7,1572792,617777,955015,4.7,12,2364109,650592,1713517,4.9,18,-791317,-6,24,0,62297,62503,369291
2009,08,107011,132203,1968346,2015038,13980,10.5,16450,12.3,259587,100849,158738,5,12.9,352970,107228,245742,5.3,17.5,-93383,-4.6,25.8,0,10587,10604,63864
2009,09,65542,81635,1468489,1507128,6257,7.6,7969,9.6,153572,52952,100620,3.5,10.2,230849,56524,174325,3.8,15.3,-77277,-5.1,20.4,0,5128,5150,30772
2009,10,17272,21873,369161,375756,2000,9.1,2362,10.7,45473,20950,24523,5.6,12.1,58662,15751,42911,4.2,15.6,-13189,-3.5,24.2,0,1457,1459,7739
2009,11,15523,19694,476547,474864,1836,9.3,1713,8.7,60365,18703,41662,3.9,12.7,56999,13643,43356,2.9,12,3366,0.7,24,0,936,939,5809
2009,12,339120,426736,6449422,6675773,48630,11.2,61236,14.1,845567,366334,479233,5.5,12.7,1298269,362522,935747,5.4,19.4,-452702,-6.7,25.4,0,42645,42873,217397
2009,13,149668,195693,3381149,3484607,19402,9.7,24941,12.5,430972,183760,247212,5.3,12.4,637887,182777,455110,5.2,18.3,-206915,-5.9,24.8,0,17251,17357,110720
2009,15,23197,29631,484394,497508,2413,8.1,2722,9.1,50411,19860,30551,4,10.1,76638,18661,57977,3.8,15.4,-26227,-5.3,20.2,0,1848,1852,10453
2009,16,31896,38562,497009,514604,3623,9.2,5315,13.4,57125,23916,33209,4.6,11.1,92314,25244,67070,4.9,17.9,-35189,-6.8,22.2,0,3463,3463,16011
2009,17,219962,279176,5104199,5258092,24157,8.6,29069,10.3,543851,204167,339684,3.9,10.3,851639,217824,633815,4.1,16.2,-307788,-5.9,20.6,0,18307,18358,115899
2009,18,100048,133404,2442532,2517770,10175,7.5,12758,9.5,268393,91730,176663,3.6,10.7,418868,99904,318964,4,16.6,-150475,-5.9,21.4,0,8376,8449,50973
2009,19,56255,73156,1271836,1285871,5203,7.1,5908,8,140588,44560,96028,3.5,10.9,168658,37308,131350,2.9,13.1,-28070,-2.2,21.8,0,3982,3986,24510
2009,20,53274,67992,1128170,1143428,5245,7.7,6080,8.9,126054,41895,84159,3.7,11,156570,37779,118791,3.3,13.7,-30516,-2.7,22,0,4163,4171,24629
2009,21,62735,83313,1473461,1507615,6671,8,7578,9,164059,60790,103269,4,10.9,232367,54014,178353,3.6,15.4,-68308,-4.5,21.8,0,5205,5229,30803
2009,22,73649,94936,1621151,1626084,7926,8.3,8085,8.5,211697,71686,140011,4.4,13,221563,60317,161246,3.7,13.6,-9866,-0.6,26,0,5698,5699,34714
2009,23,28598,35206,479794,489262,2819,7.9,3763,10.5,50294,17513,32781,3.6,10.3,69229,17675,51554,3.6,14.1,-18935,-3.8,20.6,0,2378,2379,11482
2009,24,95892,121538,2115235,2158142,10545,8.6,12771,10.4,244918,86147,158771,4,11.3,330731,90153,240578,4.2,15.3,-85813,-4,22.6,0,8212,8245,46629
2009,25,121876,153232,2944561,2995655,12166,7.9,14787,9.5,307913,105364,202549,3.5,10.3,410102,106166,303936,3.5,13.7,-102189,-3.4,20.6,0,9322,9378,55799
2009,26,153290,197404,3362798,3478306,15710,7.8,21855,10.9,401250,144970,256280,4.2,11.5,632265,164632,467633,4.7,18.2,-231015,-6.7,23,0,13799,13854,98250
2009,27,100846,128178,2380156,2442668,10732,8.3,12828,9.9,265337,89141,176196,3.6,10.9,390363,88814,301549,3.6,16,-125026,-5.1,21.8,0,7764,7804,52176
2009,28,41861,55013,896676,916080,4471,8.1,5237,9.4,104632,45076,59556,4.9,11.4,143440,38165,105275,4.2,15.7,-38808,-4.3,22.8,0,3749,3767,22065
2009,29,103325,134648,2349621,2401047,11423,8.4,14007,10.3,266831,93957,172874,3.9,11.1,369683,104372,265311,4.3,15.4,-102852,-4.3,22.2,0,9675,9693,59326
2009,30,26670,31254,337808,346462,2763,8.7,3687,11.6,39097,12305,26792,3.6,11.3,56404,15132,41272,4.4,16.3,-17307,-5,22.6,0,2267,2267,8893
2009,31,37043,46618,776246,786544,3631,7.8,3811,8.2,85055,29063,55992,3.7,10.8,105651,29951,75700,3.8,13.4,-20596,-2.6,21.6,0,2462,2469,14972
2009,32,41072,52478,1038262,1091256,6517,12.3,7632,14.4,138710,59324,79386,5.4,12.7,244698,57168,187530,5.2,22.4,-105988,-9.7,25.4,0,5413,5445,35587
2009,33,27521,33799,555042,567450,2765,8.1,3579,10.4,58670,18977,39693,3.3,10.3,83486,21416,62070,3.8,14.7,-24816,-4.4,20.6,0,2326,2331,11749
2009,34,171218,205730,3396538,3492410,18642,8.9,24053,11.5,392503,143706,248797,4.1,11.2,584246,160696,423550,4.6,16.7,-191743,-5.5,22.4,0,16514,16552,93382
2009,35,32272,40705,609261,621597,3562,8.7,4304,10.5,74155,25829,48326,4.2,11.9,98826,26660,72166,4.3,15.9,-24671,-4,23.8,0,2997,3001,15604
2009,36,383366,456158,7335110,7462859,45488,9.9,48469,10.6,835241,307453,527788,4.1,11.2,1090738,290803,799935,3.9,14.6,-255497,-3.4,22.4,0,33153,33219,176848
2009,37,149439,197716,3349957,3449936,17508,8.7,21888,10.9,366708,148087,218621,4.3,10.6,566667,143616,423051,4.2,16.4,-199959,-5.8,21.2,0,15069,15121,80082
2009,38,15624,19170,290324,291350,1505,7.8,1508,7.9,35069,11912,23157,4.1,12,37120,11345,25775,3.9,12.7,-2051,-0.7,24,0,957,958,7038
2009,39,172788,234803,4445606,4564712,17359,7.3,22159,9.3,486259,181103,305156,4,10.7,724471,187003,537468,4.1,15.9,-238212,-5.2,21.4,0,14307,14499,100080
2009,40,64651,82358,1279839,1295431,7298,8.9,7376,8.9,159069,57140,101929,4.4,12.3,190252,58167,132085,4.5,14.7,-31183,-2.4,24.6,0,5236,5245,35080
2009,41,77779,96649,1362082,1414710,8699,8.8,11408,11.6,151535,54402,97133,3.8,10.7,256791,61250,195541,4.3,18.2,-105256,-7.5,21.4,0,7722,7734,34388
2009,42,208835,273060,5025909,5112881,20912,7.6,23435,8.5,526723,177554,349169,3.5,10.3,700668,190880,509788,3.7,13.7,-173945,-3.4,20.6,0,15000,15143,97546
2009,44,21652,25369,410186,420374,1978,7.6,2895,11.2,44905,14222,30683,3.4,10.7,65281,19742,45539,4.7,15.5,-20376,-4.8,21.4,0,1875,1876,12364
2009,45,71286,93904,1533925,1584474,8234,8.6,10485,11,173890,74027,99863,4.7,11,274988,70560,204428,4.5,17.4,-101098,-6.4,22,0,7269,7352,39164
2009,46,18901,22752,325712,328010,1906,8.3,1994,8.7,38404,13765,24639,4.2,11.7,42999,11923,31076,3.6,13.1,-4595,-1.4,23.4,0,1330,1330,7702
2009,47,89911,123069,2306275,2386233,10414,8.4,12494,10.1,255765,95798,159967,4,10.7,415681,98936,316745,4.1,17.4,-159916,-6.7,21.4,0,8676,8719,58061
2009,48,348661,471556,8787033,8908457,47938,10.2,46739,9.9,1212710,478943,733767,5.4,13.6,1455558,392950,1062608,4.4,16.3,-242848,-2.7,27.2,0,31994,32203,213008
2009,49,48715,59643,1046541,1070249,6838,11.3,8466,14,141777,50969,90808,4.8,13.2,189193,56130,133063,5.2,17.7,-47416,-4.5,26.4,0,5711,5714,32281
2009,50,16258,19070,263830,267430,1527,7.9,1893,9.8,28473,11153,17320,4.2,10.6,35673,10115,25558,3.8,13.3,-7200,-2.7,21.2,0,1175,1181,5266
2009,51,133184,175757,3014449,3068091,16294,9.2,18132,10.2,369334,147830,221504,4.8,12,476619,126001,350618,4.1,15.5,-107285,-3.5,24,0,12110,12138,66668
2009,53,126072,156869,2373208,2434700,15081,9.5,19196,12,309935,100028,209907,4.1,12.7,432919,109870,323049,4.5,17.8,-122984,-5.1,25.4,0,12846,12865,63786
2009,54,27556,36314,570262,573846,2651,7.3,3038,8.3,67045,22253,44792,3.9,11.7,74212,17025,57187,3,12.9,-7167,-1.2,23.4,0,2159,2161,10657
2009,55,98835,127318,2356603,2413196,9495,7.4,11599,9,220848,73841,147007,3.1,9.2,334033,84741,249292,3.5,13.8,-113185,-4.6,18.4,0,7519,7535,46369
2009,56,15567,18185,207779,211114,1772,9.7,1831,10,28214,9117,19097,4.3,13.4,34884,9584,25300,4.5,16.5,-6670,-3.1,26.8,0,1255,1256,5876
2010,01,68309,91611,1557097,1575651,7236,7.9,8278,9,176923,61672,115251,3.9,11.2,214030,63404,150626,4,13.6,-37107,-2.4,22.4,0,5861,5891,40694
2010,02,13381,16841,251097,249695,1648,9.8,1448,8.6,34135,9272,24863,3.7,13.7,31331,7519,23812,3,12.5,2804,1.2,25,0,841,849,4196
2010,04,86469,115033,2033318,2056376,12266,10.6,13916,12,292738,123771,168967,6,14.2,338854,101831,237023,5,16.5,-46116,-2.3,28.4,0,9288,9345,54758
2010,05,45330,59242,959008,959779,4956,8.4,5061,8.5,116691,43056,73635,4.5,12.2,118234,32560,85674,3.4,12.3,-1543,-0.1,24.4,0,3479,3482,21039
2010,06,591475,747282,12292764,12463214,74886,10,80810,10.8,1554612,581224,973388,4.7,12.5,1895513,580226,1315287,4.7,15.2,-340901,-2.7,25,0,54251,54411,339689
2010,08,105043,130161,1920786,1940711,14136,10.8,15187,11.6,264158,101267,162891,5.2,13.6,304007,91109,212898,4.7,15.7,-39849,-2.1,27.2,0,9340,9352,50323
2010,09,64300,80366,1436886,1448532,6315,7.8,7009,8.7,155154,51596,103558,3.6,10.7,178446,47389,131057,3.3,12.3,-23292,-1.6,21.4,0,4509,4515,28282
2010,10,17005,21470,358148,362546,1905,8.8,2151,10,40689,15812,24877,4.4,11.2,49485,14943,34542,4.1,13.6,-8796,-2.4,22.4,0,1293,1293,6802
2010,11,15585,19921,475721,475054,1948,9.9,1618,8.2,57839,19764,38075,4.2,12.2,56504,13527,42977,2.8,11.9,1335,0.3,23.8,0,879,880,5860
2010,12,336332,423077,6391195,6402324,50482,11.9,51611,12.2,971182,394858,576324,6.2,15.2,993440,325938,667502,5.1,15.5,-22258,-0.3,30.4,0,34729,34794,190846
2010,13,146487,192051,3308877,3334780,18983,9.8,21224,11,425651,163902,261749,4.9,12.8,477459,148651,328808,4.5,14.3,-51808,-1.5,25.6,0,13860,13897,86003
2010,15,22764,29173,474458,478938,2321,7.9,2596,8.9,55899,21209,34690,4.4,11.7,64859,19619,45240,4.1,13.5,-8960,-1.8,23.4,0,1644,1645,11002
2010,16,31109,37767,487490,491316,3733,9.8,4318,11.3,65490,23135,42355,4.7,13.3,73142,20022,53120,4.1,14.9,-7652,-1.6,26.6,0,2761,2772,12104
2010,17,216836,275846,4949835,5014064,24500,8.9,25964,9.4,550144,196508,353636,3.9,11,678602,191358,487244,3.8,13.5,-128458,-2.5,22,0,15636,15687,104173
2010,18,98223,131554,2385123,2407414,9967,7.5,11004,8.3,269792,82856,186936,3.4,11.2,314374,85078,229296,3.5,13.1,-44582,-1.9,22.4,0,7121,7136,52199
2010,19,55740,72787,1246640,1256675,5189,7.1,5224,7.2,128646,39343,89303,3.1,10.2,148716,39006,109710,3.1,11.8,-20070,-1.6,20.4,0,3324,3330,24860
2010,20,52476,67257,1099879,1112150,5150,7.6,5507,8.2,119572,39340,80232,3.5,10.8,144114,40209,103905,3.6,13,-24542,-2.2,21.6,0,3639,3651,21631
2010,21,61703,82367,1445997,1455388,6557,7.9,7015,8.5,170731,62695,108036,4.3,11.7,189513,51005,138508,3.5,13,-18782,-1.3,23.4,0,4595,4604,31448
2010,22,73129,94735,1579849,1597064,7837,8.3,7619,8.1,185639,66495,119144,4.2,11.6,220068,54274,165794,3.4,13.8,-34429,-2.2,23.2,0,5180,5194,34842
2010,23,28322,35009,471330,474718,3044,8.7,3098,8.8,51543,19651,31892,4.1,10.9,58319,16923,41396,3.6,12.3,-6776,-1.4,21.8,0,1854,1854,9039
2010,24,94482,119965,2069531,2090295,10560,8.8,11543,9.6,246874,83263,163611,4,11.8,288401,78165,210236,3.7,13.8,-41527,-2,23.6,0,6976,7003,40165
2010,25,120173,151804,2895791,2909517,12824,8.4,13164,8.7,330408,109569,220839,3.8,11.4,357859,89991,267868,3.1,12.3,-27451,-0.9,22.8,0,8183,8215,50162
2010,26,149650,193215,3272283,3308320,15361,7.9,18291,9.4,400712,130494,270218,3.9,12.1,472788,136640,336148,4.1,14.3,-72076,-2.2,24.2,0,11572,11583,78427
2010,27,99643,127073,2353517,2362890,10649,8.4,11055,8.7,270198,95094,175104,4,11.4,288945,86362,202583,3.7,12.2,-18747,-0.8,22.8,0,6568,6569,42835
2010,28,41317,54554,874362,882239,4407,8.1,4596,8.4,96315,34658,61657,3.9,10.9,112068,28934,83134,3.3,12.7,-15753,-1.8,21.8,0,3209,3216,18548
2010,29,101878,133147,2285242,2310166,12186,9.1,12479,9.4,259439,92617,166822,4,11.2,309287,79042,230245,3.4,13.4,-49848,-2.2,22.4,0,8379,8403,47758
2010,30,26282,30891,334397,335519,2804,9,3035,9.8,41419,15389,26030,4.6,12.3,43663,11351,32312,3.4,13,-2244,-0.7,24.6,0,1853,1853,7397
2010,31,36994,46715,766047,769497,3674,7.9,3409,7.3,80224,27158,53066,3.5,10.4,87123,19562,67561,2.5,11.3,-6899,-0.9,20.8,0,2092,2105,11677
2010,32,40049,51504,997171,1013982,6350,12.3,6770,13.1,146553,68698,77855,6.8,14.5,180175,49641,130534,4.9,17.8,-33622,-3.3,29,0,4669,4676,32802
2010,33,27162,33438,554692,553824,2809,8.4,2944,8.8,69971,22391,47580,4,12.6,68234,17976,50258,3.2,12.3,1737,0.3,24.6,0,1924,1930,10615
2010,34,167736,201598,3327623,3352898,18711,9.2,21516,10.6,401591,144497,257094,4.3,12,452143,146853,305290,4.4,13.5,-50552,-1.5,24,0,13922,13952,81792
2010,35,31456,39840,594516,600779,3349,8.3,3992,9.9,70913,24024,46889,4,11.8,83438,21523,61915,3.6,13.9,-12525,-2.1,23.6,0,2628,2629,13648
2010,36,384271,457218,7258443,7283366,47571,10.4,44876,9.8,886924,328215,558709,4.5,12.2,936769,290714,646055,4,12.9,-49845,-0.7,24.4,0,30381,30422,174791
2010,37,147065,195119,3252301,3288940,18243,9.3,19561,10,402837,153690,249147,4.7,12.2,476115,134134,341981,4.1,14.5,-73278,-2.3,24.4,0,12322,12368,71388
2010,38,15814,19404,292423,290680,1584,8.2,1308,6.8,34790,10719,24071,3.7,12,31304,7710,23594,2.7,10.8,3486,1.2,21.6,0,784,784,3998
2010,39,168776,230640,4330787,4373318,17044,7.4,19230,8.3,479119,166757,312362,3.8,11,564181,145983,418198,3.3,12.9,-85062,-1.9,22,0,11890,11915,86081
2010,40,63978,81768,1231819,1251827,6874,8.4,7061,8.6,142414,58138,84276,4.6,11.4,182432,49877,132555,4,14.6,-40018,-3.2,22.8,0,4800,4816,30769
2010,41,76540,95661,1345119,1349219,9212,9.6,9585,10,177615,59281,118334,4.4,13.2,185814,52576,133238,3.9,13.8,-8199,-0.6,26.4,0,6188,6219,34799
2010,42,206047,270631,4937013,4969707,20746,7.7,21591,8,555877,193819,362058,3.9,11.2,621265,182054,439211,3.7,12.5,-65388,-1.3,22.4,0,13440,13456,103895
2010,44,21240,25045,395613,401793,2197,8.7,2382,9.5,42501,16896,25605,4.2,10.6,54861,13335,41526,3.3,13.7,-12360,-3.1,21.2,0,1550,1550,8554
2010,45,69779,92474,1487337,1502711,8144,8.8,9065,9.8,182885,72804,110081,4.8,12.2,213634,55154,158480,3.7,14.2,-30749,-2,24.4,0,6080,6125,34737
2010,46,18888,22818,321024,322349,1870,8.2,1735,7.6,36530,13077,23453,4.1,11.3,39180,10753,28427,3.3,12.2,-2650,-0.9,22.6,0,1109,1109,7094
2010,47,88094,121225,2252614,2271366,10128,8.3,10980,9,271240,93997,177243,4.1,11.9,308745,86353,222392,3.8,13.6,-37505,-1.7,23.8,0,7468,7494,51605
2010,48,348248,472374,8654857,8701186,47216,10,43204,9.2,1206669,479146,727523,5.5,13.9,1299328,375722,923606,4.3,14.9,-92659,-1,27.8,0,29270,29348,214455
2010,49,48045,58940,1006560,1024126,6933,11.7,7209,12.2,129724,51952,77772,5.1,12.7,164856,47369,117487,4.6,16.1,-35132,-3.4,25.4,0,4662,4684,30049
2010,50,16094,18929,261242,262339,1482,7.8,1570,8.3,25774,8709,17065,3.3,9.8,27968,7394,20574,2.8,10.7,-2194,-0.9,19.6,0,961,967,4784
2010,51,131474,174051,2955556,2972940,15688,9,16266,9.3,376263,134071,242192,4.5,12.7,411031,125844,285187,4.2,13.8,-34768,-1.1,25.4,0,10130,10160,62347
2010,53,124320,155140,2298899,2331154,15275,9.8,16049,10.3,276426,108722,167704,4.7,11.9,340935,91745,249190,3.9,14.6,-64509,-2.7,23.8,0,10454,10489,52036
2010,54,26884,35741,556530,562235,2459,6.8,2831,7.9,64097,21986,42111,3.9,11.4,75507,19931,55576,3.5,13.4,-11410,-2,22.8,0,1885,1905,12372
2010,55,97188,125869,2306974,2326373,9295,7.4,10021,7.9,229942,76122,153820,3.3,9.9,268740,73668,195072,3.2,11.6,-38798,-1.7,19.8,0,6366,6371,42665
2010,56,15163,17795,196799,201268,1547,8.6,1815,10.1,23351,8185,15166,4.1,11.6,32288,8518,23770,4.2,16,-8937,-4.4,23.2,0,1158,1158,4821
2011,01,67013,90232,1559352,1553149,7308,8.1,7951,8.8,191850,64020,127830,4.1,12.4,179443,53261,126182,3.4,11.6,12407,0.8,23.2,0,5369,5393,29016
2011,02,13339,16965,252323,251986,1642,9.7,1492,8.8,31676,10061,21615,4,12.6,31002,8420,22582,3.3,12.3,674,0.3,24.6,0,856,861,4102
2011,04,85339,114040,2075076,2048945,12639,11.1,12809,11.2,316018,106373,209645,5.2,15.4,263756,88718,175038,4.3,12.9,52262,2.5,25.8,0,8445,8492,53681
2011,05,44767,58774,969699,962552,5109,8.7,5139,8.7,124223,41156,83067,4.3,12.9,109928,33699,76229,3.5,11.4,14295,1.5,22.8,0,3510,3525,20023
2011,06,590584,748458,12451740,12340963,79745,10.7,74294,10,1751088,573390,1177698,4.6,14.2,1529535,530777,998758,4.3,12.4,221553,1.8,24.8,0,49559,49745,307002
2011,08,104338,129760,1942202,1926868,14530,11.2,14018,10.8,279209,94578,184631,4.9,14.5,248542,80449,168093,4.2,12.9,30667,1.6,25.8,0,8734,8744,48221
2011,09,63236,79287,1442053,1437538,6281,7.9,6889,8.6,163334,52051,111283,3.6,11.4,154303,48349,105954,3.4,10.7,9031,0.7,21.4,0,4362,4370,23570
2011,10,16787,21191,357129,357296,1920,9,2018,9.5,43410,13549,29861,3.8,12.1,43744,14130,29614,4,12.2,-334,-0.1,24.2,0,1222,1222,6347
2011,11,15706,20165,489847,482205,1866,9.3,1482,7.4,62907,18491,44416,3.8,13,47623,11434,36189,2.4,9.9,15284,3.1,19.8,0,823,823,6430
2011,12,337537,425180,6533441,6460908,53493,12.6,49052,11.6,1070538,406432,664106,6.3,16.6,925472,349482,575990,5.4,14.3,145066,2.3,28.6,0,33118,33209,190027
2011,13,144809,190576,3312244,3298519,19555,10.3,19705,10.3,458069,155931,302138,4.7,13.9,430619,154434,276185,4.7,13.1,27450,0.8,26.2,0,13020,13057,82720
2011,15,22388,28869,480386,476669,2335,8.1,2390,8.3,57840,19386,38454,4.1,12.1,50405,15970,34435,3.4,10.6,7435,1.5,21.2,0,1623,1627,9448
2011,16,30134,36806,481490,483705,3581,9.6,4220,11.3,61318,20350,40968,4.2,12.7,65748,20837,44911,4.3,13.6,-4430,-0.9,25.4,0,2652,2660,13905
2011,17,215800,275240,5009339,4969298,26068,9.5,24939,9.1,625651,200466,425185,4,12.6,545570,166807,378763,3.4,11,80081,1.6,22,0,15366,15544,95503
2011,18,96669,130392,2420711,2398400,10642,8.2,10709,8.2,294609,87223,207386,3.6,12.3,249987,76414,173573,3.2,10.4,44622,1.9,20.8,0,7009,7043,46968
2011,19,55092,72304,1262576,1252562,5346,7.4,5444,7.5,140527,40358,100169,3.2,11.2,120498,33157,87341,2.6,9.6,20029,1.6,19.2,0,3419,3428,19369
2011,20,51402,66564,1096521,1096570,5444,8.2,5672,8.5,131685,47391,84294,4.3,12,131783,38419,93364,3.5,12,-98,0,24,0,3766,3768,22733
2011,21,60544,81479,1449608,1444962,6575,8,6802,8.3,174281,54147,120134,3.7,12.1,164989,50692,114297,3.5,11.4,9292,0.7,22.8,0,4683,4695,30695
2011,22,72574,94665,1598837,1587766,7994,8.5,7622,8.1,209133,70584,138549,4.4,13.2,186991,52480,134511,3.3,11.8,22142,1.4,23.6,0,5252,5268,30919
2011,23,27836,34526,470149,469665,2998,8.6,3235,9.3,53185,18599,34586,4,11.3,52216,16984,35232,3.6,11.1,969,0.2,22.2,0,1903,1907,10301
2011,24,93326,119320,2098174,2079515,10884,9.1,10646,8.9,273094,90617,182477,4.4,13.1,235776,66228,169548,3.2,11.3,37318,1.8,22.6,0,6781,6785,38022
2011,25,119684,151698,2921203,2902293,13117,8.7,12237,8.1,331528,96314,235214,3.3,11.4,293709,81204,212505,2.8,10.1,37819,1.3,20.2,0,7624,7631,42670
2011,26,148091,192152,3373178,3316652,16662,8.7,16624,8.6,479423,126206,353217,3.8,14.5,366372,118848,247524,3.6,11,113051,3.5,22,0,10566,10597,71827
2011,27,98958,126765,2398862,2373328,11038,8.7,10755,8.5,284260,86391,197869,3.6,12,233193,70902,162291,3,9.8,51067,2.2,19.6,0,6604,6623,42796
2011,28,40741,54116,879867,875789,4370,8.1,4427,8.2,102691,36121,66570,4.1,11.7,94535,28771,65764,3.3,10.8,8156,0.9,21.6,0,3115,3121,17698
2011,29,99809,131606,2282232,2279005,11952,9.1,12657,9.6,258378,82304,176074,3.6,11.3,251924,74203,177721,3.3,11.1,6454,0.2,22.2,0,8914,8920,47117
2011,30,25815,30437,330498,332629,2883,9.4,3087,10.1,40051,12554,27497,3.8,12,44312,16311,28001,4.9,13.3,-4261,-1.3,24,0,1872,1881,11434
2011,31,36588,46481,757267,759973,3788,8.1,3693,7.9,86845,27090,59755,3.6,11.4,92257,33154,59103,4.4,12.1,-5412,-0.7,22.8,0,2308,2314,13516
2011,32,39829,51417,992223,992737,6384,12.4,6084,11.9,133323,46742,86581,4.7,13.4,134351,45916,88435,4.6,13.5,-1028,-0.1,26.8,0,4235,4262,32216
2011,33,26731,33030,544683,548780,2685,8.1,2883,8.7,57257,16970,40287,3.1,10.4,65450,17930,47520,3.3,11.9,-8193,-1.5,20.8,0,1924,1924,11192
2011,34,166309,200448,3346299,3329964,19768,9.9,19913,9.9,429588,141465,288123,4.2,12.9,396919,126943,269976,3.8,11.9,32669,1,23.8,0,13313,13343,72524
2011,35,31031,39592,594682,594037,3615,9.1,3622,9.1,72305,24117,48188,4.1,12.2,71014,18773,52241,3.2,12,1291,0.2,24,0,2456,2461,12203
2011,36,385117,459053,7363248,7297157,48755,10.7,45135,9.9,958324,321549,636775,4.4,13.1,826144,281166,544978,3.9,11.3,132180,1.8,22.6,0,30479,30525,166997
2011,37,144978,193170,3297575,3264355,17930,9.3,18251,9.4,427665,139388,288277,4.3,13.1,361224,111297,249927,3.4,11.1,66441,2,22.2,0,12172,12248,70369
2011,38,15966,19700,299809,295747,1856,9.5,1442,7.4,38671,12781,25890,4.3,13.1,30546,8623,21923,2.9,10.3,8125,2.8,20.6,0,926,928,5748
2011,39,166689,228282,4403715,4357379,17683,7.7,18409,8,551778,156176,395602,3.6,12.7,459107,133746,325361,3.1,10.5,92671,2.2,21,0,11430,11490,78508
2011,40,63234,81323,1250561,1238630,7173,8.8,7056,8.7,164974,51579,113395,4.2,13.3,141113,45383,95730,3.7,11.4,23861,1.9,22.8,0,4891,4905,28940
2011,41,75853,95050,1334988,1333135,9196,9.7,9140,9.6,171701,49739,121962,3.7,12.9,167996,48486,119510,3.6,12.6,3705,0.3,25.2,0,5971,6015,29732
2011,42,204451,270195,5022702,4968181,21855,8.1,20298,7.5,620245,197565,422680,4,12.5,511202,152980,358222,3.1,10.3,109043,2.2,20.6,0,12955,12985,84518
2011,44,20958,24814,404568,399466,2177,8.8,2266,9.1,49250,14790,34460,3.7,12.3,39046,12855,26191,3.2,9.8,10204,2.5,19.6,0,1428,1431,6613
2011,45,68279,91070,1501794,1491568,7963,8.7,8667,9.5,199135,64008,135127,4.3,13.4,178684,56312,122372,3.8,12,20451,1.4,24,0,5869,5886,36245
2011,46,18673,22699,318154,319150,1850,8.1,1854,8.2,37042,13067,23975,4.1,11.6,39034,13447,25587,4.2,12.2,-1992,-0.6,23.2,0,1193,1202,9527
2011,47,86652,119647,2282353,2261749,10255,8.5,10717,8.9,291805,81799,210006,3.6,12.9,250597,83132,167465,3.7,11.1,41208,1.8,22.2,0,7370,7436,46629
2011,48,348526,475059,8832993,8725992,49385,10.5,43344,9.2,1314158,455216,858942,5.2,15.1,1100156,336430,763726,3.9,12.6,214002,2.5,25.2,0,29737,29905,206349
2011,49,47970,59067,1016982,1010121,6945,11.8,6445,11,139750,50588,89162,5,13.8,126029,40212,85817,4,12.5,13721,1.3,25,0,4179,4198,26514
2011,50,15835,18631,262082,261283,1468,7.8,1674,8.9,27347,7659,19688,2.9,10.5,25748,7889,17859,3,9.9,1599,0.6,19.8,0,1044,1048,4666
2011,51,129895,173214,2985282,2962845,16468,9.5,15775,9.1,402462,134609,267853,4.5,13.6,357588,105220,252368,3.6,12.1,44874,1.5,24.2,0,10228,10252,59331
2011,53,121993,152946,2277547,2283205,15335,10,16264,10.6,310005,97893,212112,4.3,13.6,321321,113095,208226,5,14.1,-11316,-0.5,27.2,0,10567,10586,52444
2011,54,26243,35267,558302,555542,2621,7.4,2824,8,65725,18403,47322,3.3,11.8,60204,16719,43485,3,10.8,5521,1,21.6,0,1961,1962,11291
2011,55,95468,124286,2334126,2316296,9224,7.4,10019,8,256869,72295,184574,3.1,11.1,221209,62461,158748,2.7,9.6,35660,1.5,19.2,0,6324,6361,38882
2011,56,15218,17900,200847,198960,1799,10.1,1631,9.2,29095,9200,19895,4.6,14.6,25321,7674,17647,3.9,12.7,3774,1.9,25.4,0,1029,1029,4610
2012,01,67040,90410,1568462,1560918,7896,8.8,7593,8.4,202366,61103,141263,3.9,13,187278,57908,129370,3.7,12,15088,1,24,0,4781,4835,30569
2012,02,13511,17129,256280,254120,1742,10.2,1618,9.5,39738,12646,27092,5,15.6,35418,8240,27178,3.2,13.9,4320,1.7,27.8,0,782,789,3692
2012,04,85908,114681,2105257,2085298,12839,11.3,12008,10.5,329552,110836,218716,5.3,15.8,289633,97214,192419,4.7,13.9,39919,1.9,27.8,0,7236,7329,42669
2012,05,44996,58976,967882,967495,5117,8.7,4998,8.5,121580,35285,86295,3.6,12.6,120806,37716,83090,3.9,12.5,774,0.1,25,0,3128,3166,18739
2012,06,600518,758097,12715046,12562400,84324,11.2,74867,10,1902028,593971,1308057,4.7,15.1,1596736,547326,1049410,4.4,12.7,305292,2.4,25.4,0,45546,45970,277550
2012,08,105729,131110,1997467,1967362,14968,11.5,13521,10.4,299141,99671,199470,5.1,15.2,238931,82962,155969,4.2,12.1,60210,3.1,24.2,0,7756,7832,40588
2012,09,63690,79786,1479590,1459539,7075,8.9,6541,8.2,197279,52856,144423,3.6,13.5,157176,48708,108468,3.3,10.8,40103,2.7,21.6,0,3899,3929,22776
2012,10,16757,21303,362981,359730,2181,10.3,2031,9.6,51846,18310,33536,5.1,14.4,45343,19387,25956,5.4,12.6,6503,1.8,25.2,0,1151,1158,6259
2012,11,15848,20144,494353,489072,1791,8.9,1690,8.4,66211,18326,47885,3.7,13.5,55649,14703,40946,3,11.4,10562,2.1,22.8,0,823,835,6521
2012,12,347336,435977,6743166,6631502,55709,13,45371,10.6,1116868,381064,735804,5.7,16.8,893541,371051,522490,5.6,13.5,223327,3.3,27,0,28696,29020,211495
2012,13,146087,192068,3363704,3330625,21132,11.1,19523,10.2,493470,171518,321952,5.1,14.8,427311,154181,273130,4.6,12.8,66159,2,25.6,0,11546,11651,68040
2012,15,22387,28754,492143,485956,2351,8.2,2445,8.5,61367,19637,41730,4,12.6,48992,16954,32038,3.5,10.1,12375,2.5,20.2,0,1392,1401,7073
2012,16,30496,37172,493637,487577,3983,10.8,3744,10.1,74554,26324,48230,5.4,15.3,62435,25341,37094,5.2,12.8,12119,2.5,25.6,0,2228,2253,10421
2012,17,217700,276756,5078998,5037329,26914,9.8,25193,9.1,682367,207932,474435,4.1,13.5,599029,202332,396697,4,11.9,83338,1.6,23.8,0,14126,14253,86068
2012,18,97354,131243,2511418,2470343,11593,8.9,10838,8.3,347070,103356,243714,4.2,14,264921,82451,182470,3.3,10.7,82149,3.3,21.4,0,6269,6372,41382
2012,19,55616,73020,1286429,1272154,6074,8.4,5396,7.4,158715,43472,115243,3.4,12.5,130164,44966,85198,3.5,10.2,28551,2.3,20.4,0,3116,3136,19102
2012,20,51741,66938,1123285,1109227,5905,8.9,5610,8.4,151520,51863,99657,4.7,13.7,123403,40062,83341,3.6,11.1,28117,2.6,22.2,0,3264,3317,20085
2012,21,60938,82047,1485268,1465476,7250,8.9,6818,8.4,207525,65803,141722,4.5,14.2,167942,51842,116100,3.5,11.5,39583,2.7,23,0,4089,4127,23720
2012,22,73250,95673,1628860,1613352,8626,9.1,7772,8.2,230277,69570,160707,4.3,14.3,199262,58654,140608,3.6,12.4,31015,1.9,24.8,0,4707,4753,31822
2012,23,27876,34656,479325,474236,3320,9.6,3196,9.3,63384,19953,43431,4.2,13.4,53206,17783,35423,3.7,11.2,10178,2.2,22.4,0,1818,1830,9451
2012,24,94702,120696,2147147,2120412,11479,9.6,10190,8.5,304169,95644,208525,4.5,14.3,250698,80763,169935,3.8,11.8,53471,2.5,23.6,0,5840,5899,33511
2012,25,121449,153355,2992818,2951346,14300,9.4,12519,8.2,379511,102465,277046,3.5,12.9,296566,94252,202314,3.2,10,82945,2.9,20,0,7176,7265,45369
2012,26,149907,193894,3463460,3414408,17908,9.3,16422,8.5,509357,146760,362597,4.3,14.9,411254,159532,251722,4.7,12,98103,2.9,24,0,9349,9477,81485
2012,27,99812,127577,2464287,2428855,11563,9.1,10649,8.4,321360,80423,240937,3.3,13.2,250496,79510,170986,3.3,10.3,70864,2.9,20.6,0,5791,5865,41428
2012,28,40654,54240,888208,883500,4482,8.3,4547,8.4,110507,32522,77985,3.7,12.5,101091,28417,72674,3.2,11.4,9416,1.1,22.8,0,2924,2940,15878
2012,29,99998,131820,2320835,2298178,12941,9.8,12620,9.6,303925,98084,205841,4.3,13.2,258611,80337,178274,3.5,11.3,45314,1.9,22.6,0,8060,8147,40556
2012,30,26311,31009,339112,334743,3323,10.8,2844,9.3,48548,16537,32011,4.9,14.5,39810,12874,26936,3.8,11.9,8738,2.6,23.8,0,1645,1661,6937
2012,31,37168,47067,779311,767653,4059,8.7,3593,7.7,102737,33148,69589,4.3,13.4,79421,22368,57053,2.9,10.3,23316,3.1,20.6,0,2057,2088,11544
2012,32,40292,51834,1021825,1005799,6486,12.6,5950,11.6,158575,59107,99468,5.9,15.8,126523,47613,78910,4.7,12.6,32052,3.2,25.2,0,3767,3817,26410
2012,33,26950,33332,541979,543887,3113,9.4,2841,8.6,65235,20506,44729,3.8,12,69050,28729,40321,5.3,12.7,-3815,-0.7,24,0,1718,1749,10978
2012,34,168215,202368,3399094,3369316,21240,10.6,19176,9.5,471294,134059,337235,4,14,411738,135009,276729,4,12.2,59556,1.8,24.4,0,12074,12153,63242
2012,35,31183,39776,594003,592770,3821,9.6,3636,9.2,80965,27808,53157,4.7,13.7,78498,25076,53422,4.2,13.2,2467,0.5,26.4,0,2202,2262,11098
2012,36,391663,465996,7537447,7441512,51047,11,43871,9.5,1014333,311589,702744,4.2,13.6,822463,270642,551821,3.6,11.1,191870,2.5,22.2,0,28604,28796,148697
2012,37,146425,195059,3372680,3326358,19306,10,17574,9.1,476768,142018,334750,4.3,14.3,384124,124298,259826,3.7,11.5,92644,2.8,23,0,10534,10616,63645
2012,38,16787,20683,324211,311942,2386,11.8,1513,7.5,56541,18974,37567,6.1,18.1,32003,10886,21117,3.5,10.3,24538,7.8,20.6,0,944,954,6546
2012,39,167489,229141,4511135,4447644,19471,8.5,18429,8.1,622130,171479,450651,3.9,14,495147,163276,331871,3.7,11.1,126983,2.9,22.2,0,10485,10608,78617
2012,40,64261,82595,1285443,1266162,7971,9.7,6868,8.4,189993,63397,126596,5,15,151431,48527,102904,3.8,12,38562,3,24,0,4246,4284,25046
2012,41,76776,95825,1364965,1348910,10035,10.5,9293,9.7,192314,62149,130165,4.6,14.3,160205,52785,107420,3.9,11.9,32109,2.4,23.8,0,5284,5326,26531
2012,42,206269,271751,5119718,5059873,22803,8.4,21119,7.8,669863,201721,468142,4,13.2,550172,169839,380333,3.4,10.9,119691,2.3,21.8,0,12306,12433,79417
2012,44,21068,24912,407443,405522,2363,9.5,2239,9,50745,16426,34319,4.1,12.5,46902,13950,32952,3.4,11.6,3843,0.9,23.2,0,1299,1311,6761
2012,45,68781,91685,1531327,1515443,8429,9.2,7938,8.7,210608,64257,146351,4.2,13.9,178841,54632,124209,3.6,11.8,31767,2.1,23.6,0,4815,4869,26541
2012,46,18994,23119,330580,324280,2164,9.4,1845,8.1,45311,15643,29668,4.8,14,32710,10300,22410,3.2,10.1,12601,3.9,20.2,0,1125,1134,5390
2012,47,86957,120249,2338517,2307993,11049,9.2,10552,8.8,317646,96938,220708,4.2,13.8,256599,85157,171442,3.7,11.1,61047,2.7,22.2,0,6484,6532,39797
2012,48,357026,485545,9217732,9032122,53845,11.2,43515,9.1,1475139,493447,981692,5.5,16.3,1103919,370478,733441,4.1,12.2,371220,4.1,24.4,0,26777,27137,179303
2012,49,49094,60359,1058738,1037334,7496,12.6,6240,10.5,168997,58194,110803,5.6,16.3,126190,43588,82602,4.2,12.2,42807,4.1,24.4,0,3796,3847,26546
2012,50,15939,18787,265345,263455,1748,9.4,1609,8.6,37320,9592,27728,3.6,14.2,33540,9546,23994,3.6,12.7,3780,1.5,25.4,0,952,962,5210
2012,51,131180,174438,3043321,3009713,16844,9.7,15559,9,455500,133653,321847,4.4,15.1,388285,122593,265692,4.1,12.9,67215,2.2,25.8,0,8951,9071,48808
2012,53,122980,153935,2317162,2295186,16452,10.7,15606,10.2,326240,102272,223968,4.5,14.2,282289,88545,193744,3.9,12.3,43951,1.9,24.6,0,9124,9210,44907
2012,54,26246,35296,572371,564982,2760,7.8,2774,7.9,77884,22702,55182,4,13.8,63106,20438,42668,3.6,11.2,14778,2.6,22.4,0,1674,1702,9193
2012,55,95700,124623,2370110,2349754,10408,8.4,10087,8.1,278323,77435,200888,3.3,11.8,237611,72158,165453,3.1,10.1,40712,1.7,20.2,0,5867,5935,35075
2012,56,15471,18185,206732,203410,1923,10.7,1687,9.4,34525,11269,23256,5.5,17,27880,10840,17040,5.3,13.7,6645,3.3,27.4,0,1016,1043,4929
2013,01,66905,90227,1591358,1578455,7072,7.9,7214,8,199009,58278,140731,3.7,12.6,173203,57259,115944,3.6,11,25806,1.6,22,0,4806,4824,32696
2013,02,13645,17283,263792,259981,1691,9.9,1553,9,34748,9449,25299,3.6,13.4,27125,7658,19467,2.9,10.4,7623,3,20.8,0,836,837,4401
2013,04,86916,115965,2144104,2120586,12161,10.6,10954,9.5,299357,96354,203003,4.5,14.1,252321,81510,170811,3.8,11.9,47036,2.2,23.8,0,6918,6963,47037
2013,05,45012,59083,973985,969813,4916,8.3,4852,8.2,116163,36152,80011,3.7,12,107820,36143,71677,3.7,11.1,8343,0.9,22.2,0,3278,3324,18667
2013,06,608395,766124,13207253,12944028,81236,10.7,73969,9.7,1997127,658867,1338260,5.1,15.4,1470679,512769,957910,4,11.4,526448,4,22.8,0,46510,46788,295224
2013,08,107578,133041,2090868,2040954,14812,11.2,12914,9.8,333623,96507,237116,4.7,16.3,233796,83035,150761,4.1,11.5,99827,4.8,23,0,7841,7866,47206
2013,09,63598,79762,1496631,1486501,6565,8.3,6569,8.3,166252,49151,117101,3.3,11.2,145992,45339,100653,3.1,9.8,20260,1.4,19.6,0,3928,3955,25969
2013,10,16899,21471,385206,373356,2008,9.4,1815,8.5,61253,23824,37429,6.4,16.4,37552,11814,25738,3.2,10.1,23701,6.3,20.2,0,1088,1095,5799
2013,11,16060,20517,500767,496221,2017,10,1572,7.8,60257,19815,40442,4,12.1,51164,17192,33972,3.5,10.3,9093,1.8,20.6,0,849,853,8653
2013,12,355174,444381,6909700,6820517,52751,12,45746,10.4,1027366,360452,666914,5.3,15.1,849000,302470,546530,4.4,12.4,178366,2.7,24.8,0,29482,29569,168779
2013,13,147556,193563,3422425,3383796,19387,10.1,17793,9.3,466566,137800,328766,4.1,13.8,389309,139291,250018,4.1,11.5,77257,2.3,23,0,11246,11277,75615
2013,15,22478,28843,499723,495066,2318,8.1,2220,7.7,57897,17647,40250,3.6,11.7,48582,17670,30912,3.6,9.8,9315,1.9,19.6,0,1350,1357,9733
2013,16,30798,37488,514551,503402,3784,10.2,3564,9.6,73641,23448,50193,4.7,14.6,51343,17858,33485,3.5,10.2,22298,4.4,20.4,0,2251,2255,12170
2013,17,218024,277239,5178772,5120985,25275,9.2,24720,9,666953,212443,454510,4.1,13,551380,183664,367716,3.6,10.8,115573,2.2,21.6,0,14651,14763,100278
2013,18,96954,130644,2545517,2518862,9924,7.6,10353,7.9,307325,86234,221091,3.4,12.2,254015,75392,178623,3,10.1,53310,2.1,20.2,0,6514,6543,45883
2013,19,55291,72903,1299330,1291407,5218,7.2,5272,7.2,136448,41032,95416,3.2,10.6,120603,36421,84182,2.8,9.3,15845,1.3,18.6,0,3249,3270,20245
2013,20,51585,66766,1139995,1129544,5170,7.8,5271,7.9,138815,41632,97183,3.7,12.3,117912,36007,81905,3.2,10.4,20903,1.9,20.8,0,3416,3434,22133
2013,21,61239,82512,1495939,1487223,7015,8.6,6420,7.8,190259,61543,128716,4.1,12.8,172827,57996,114831,3.9,11.6,17432,1.2,23.2,0,4200,4216,29184
2013,22,73489,95911,1666487,1644516,7617,8,7455,7.8,226634,65220,161414,4,13.8,182692,59166,123526,3.6,11.1,43942,2.7,22.2,0,4869,4889,37746
2013,23,27767,34520,477712,477017,2868,8.3,2971,8.6,54314,17235,37079,3.6,11.4,52925,18858,34067,4,11.1,1389,0.3,22.2,0,1725,1738,11172
2013,24,95277,121666,2183851,2162804,11029,9.1,10147,8.4,284873,98914,185959,4.6,13.2,242779,75954,166825,3.5,11.2,42094,2,22.4,0,5998,6029,43516
2013,25,122283,154320,3059465,3023432,13114,8.5,12214,8,353815,106509,247306,3.5,11.7,281751,87877,193874,2.9,9.3,72064,2.4,18.6,0,7211,7287,48670
2013,26,150130,193720,3530832,3493413,15710,8.1,15922,8.2,440161,127864,312297,3.7,12.6,365323,107215,258108,3.1,10.5,74838,2.1,21,0,9677,9701,63954
2013,27,100081,128130,2499645,2480836,10581,8.3,10010,7.9,291624,80118,211506,3.2,11.8,254006,68055,185951,2.7,10.2,37618,1.6,20.4,0,5922,5928,43419
2013,28,40653,54222,893710,889329,4073,7.5,4102,7.6,98923,28103,70820,3.2,11.1,90160,24281,65879,2.7,10.1,8763,1,20.2,0,2871,2891,17954
2013,29,101482,133391,2360576,2336733,13048,9.9,11426,8.6,283378,80437,202941,3.4,12.1,235692,72775,162917,3.1,10.1,47686,2,20.2,0,7507,7562,41846
2013,30,26602,31322,351590,344744,3099,10,2833,9.1,48878,18202,30676,5.3,14.2,35185,11532,23653,3.3,10.2,13693,4,20.4,0,1720,1727,7902
2013,31,37230,47252,779083,778041,3717,7.9,3537,7.5,87545,24617,62928,3.2,11.3,85460,24764,60696,3.2,11,2085,0.3,22,0,2254,2264,13916
2013,32,40954,52566,1039991,1029297,6350,12.2,5555,10.7,153705,55777,97928,5.4,14.9,132317,47147,85170,4.6,12.9,21388,2,25.8,0,3674,3719,29562
2013,33,26892,33336,543054,541506,2749,8.3,2728,8.2,61947,18497,43450,3.4,11.4,58850,17305,41545,3.2,10.9,3097,0.5,21.8,0,1722,1726,9901
2013,34,169057,203522,3460293,3427468,20074,9.9,19267,9.5,477643,141598,336045,4.1,13.9,411992,141136,270856,4.1,12,65651,1.9,24,0,12273,12329,80547
2013,35,31114,39680,596185,594029,3398,8.6,3544,8.9,80797,26180,54617,4.4,13.6,76484,24174,52310,4.1,12.9,4313,0.7,25.8,0,2325,2347,14365
2013,36,395139,468881,7679490,7601643,48036,10.3,45751,9.8,997210,325921,671289,4.3,13.1,841517,286312,555205,3.8,11.1,155693,2,22.2,0,28412,28584,163837
2013,37,147227,196421,3414578,3385642,18047,9.2,16736,8.6,448489,142089,306400,4.2,13.2,390617,118577,272040,3.5,11.5,57872,1.7,23,0,10898,10931,65858
2013,38,17201,21254,337066,329645,2186,10.4,1626,7.8,51688,16764,34924,5.1,15.7,36845,12754,24091,3.9,11.2,14843,4.5,22.4,0,1079,1079,7822
2013,39,166750,228573,4582324,4540054,17370,7.6,17332,7.6,570568,154382,416186,3.4,12.6,486029,144560,341469,3.2,10.7,84539,1.9,21.4,0,10639,10696,79921
2013,40,64986,83453,1316127,1299486,7345,8.9,6585,8,176738,56946,119792,4.4,13.6,143456,48036,95420,3.7,11,33282,2.6,22,0,4417,4447,32804
2013,41,77773,96996,1410990,1385753,9433,9.8,8215,8.5,191934,56099,135835,4,13.9,141460,44471,96989,3.2,10.2,50474,3.7,20.4,0,5241,5249,28033
2013,42,206131,272479,5142302,5126320,21418,7.9,20442,7.5,589747,180455,409292,3.5,11.5,557782,158583,399199,3.1,10.9,31965,0.6,21.8,0,12634,12678,97083
2013,44,20940,24852,414150,410711,2066,8.3,2172,8.7,46939,12710,34229,3.1,11.4,40060,12941,27119,3.2,9.8,6879,1.6,19.6,0,1326,1327,7621
2013,45,69262,92043,1563157,1543565,7916,8.7,7432,8.1,200431,60986,139445,4,13,161246,46329,114917,3,10.4,39185,2.6,20.8,0,4864,4911,27081
2013,46,19097,23223,333429,331673,1805,7.8,1761,7.6,40013,11552,28461,3.5,12.1,36500,13119,23381,4,11,3513,1.1,22,0,1129,1129,7176
2013,47,87354,120750,2395762,2362705,10349,8.6,9741,8.1,322606,92984,229622,3.9,13.7,256491,74330,182161,3.1,10.9,66115,2.8,21.8,0,6436,6489,43979
2013,48,364402,494516,9513566,9351528,51051,10.4,42183,8.6,1453062,465621,987441,5,15.5,1128988,377462,751526,4,12.1,324074,3.4,24.2,0,27421,27572,206469
2013,49,50323,61781,1089218,1072434,7153,11.7,5891,9.7,163654,56552,107102,5.3,15.3,130086,48524,81562,4.5,12.1,33568,3.2,24.2,0,3572,3586,30590
2013,50,15853,18684,257184,261224,1384,7.4,1499,8,29017,8778,20239,3.4,11.1,37096,18803,18293,7.2,14.2,-8079,-3.1,22.2,0,923,923,15905
2013,51,132186,175936,3088258,3059020,16361,9.4,14705,8.4,413385,136552,276833,4.5,13.5,354910,100286,254624,3.3,11.6,58475,1.9,23.2,0,8909,8936,55527
2013,53,124773,155742,2382048,2345646,16097,10.4,14374,9.3,325387,103357,222030,4.4,13.9,252583,91042,161541,3.9,10.8,72804,3.1,21.6,0,9111,9163,49550
2013,54,25813,34873,569515,570133,2333,6.7,2773,7.9,65361,19542,45819,3.4,11.5,66597,21140,45457,3.7,11.7,-1236,-0.2,23,0,1776,1785,11409
2013,55,95392,124334,2392333,2377451,9345,7.5,9497,7.7,254715,69260,185455,2.9,10.7,224952,64469,160483,2.7,9.5,29763,1.2,19,0,5763,5807,37824
2013,56,15429,18193,210463,208589,1690,9.3,1715,9.5,30543,9739,20804,4.7,14.6,26795,8998,17797,4.3,12.8,3748,1.8,25.6,0,1128,1131,5881
2014,01,66639,90262,1594940,1586747,7362,8.2,6673,7.4,195276,64785,130491,4.1,12.3,178890,51041,127849,3.2,11.3,16386,1,22.6,0,4735,4756,30992
2014,02,13668,17400,265837,264385,1782,10.3,1576,9.1,37459,13574,23885,5.1,14.2,34554,8977,25577,3.4,13.1,2905,1.1,26.2,0,956,960,4320
2014,04,87630,117069,2197999,2164328,12907,11.1,10889,9.4,344444,115808,228636,5.4,15.9,277101,87555,189546,4,12.8,67343,3.1,25.6,0,7254,7305,46332
2014,05,44785,58857,986738,976238,4918,8.4,4717,8,124883,38868,86015,4,12.8,103883,35498,68385,3.6,10.6,21000,2.2,21.2,0,3390,3425,18691
2014,06,618806,777350,13507087,13316457,88765,11.5,72794,9.5,2037294,675960,1361334,5.1,15.3,1656034,566133,1089901,4.3,12.4,381260,2.9,24.8,0,49743,49911,315029
2014,08,109377,135227,2144675,2112718,15835,11.8,12729,9.5,344553,116999,227554,5.5,16.3,280639,82673,197966,3.9,13.3,63914,3,26.6,0,8403,8419,45332
2014,09,63296,79574,1488006,1488347,6748,8.5,6410,8.1,166467,50376,116091,3.4,11.2,167149,50830,116319,3.4,11.2,-682,0,22.4,0,4194,4218,23346
2014,10,17065,21558,392154,387605,2134,10,1866,8.7,59701,20256,39445,5.2,15.4,50603,14703,35900,3.8,13.1,9098,2.3,26.2,0,1173,1178,6272
2014,11,16093,20657,503649,500158,1910,9.3,1555,7.6,58649,18132,40517,3.6,11.7,51666,13567,38099,2.7,10.3,6983,1.4,20.6,0,952,954,6846
2014,12,361103,451333,7041161,6940898,56329,12.6,46565,10.4,1077880,372185,705695,5.4,15.5,877354,333059,544295,4.8,12.6,200526,2.9,25.2,0,32351,32436,183748
2014,13,148640,195566,3466866,3428625,20904,10.8,17455,9,488302,155344,332958,4.5,14.2,411820,150138,261682,4.4,12,76482,2.2,24,0,11941,11978,67350
2014,15,22425,28929,510182,502243,2415,8.4,2167,7.5,60535,18811,41724,3.7,12.1,44657,13525,31132,2.7,8.9,15878,3.2,17.8,0,1516,1521,8384
2014,16,31371,38119,529621,520541,4144,11,3316,8.8,78783,22919,55864,4.4,15.1,60622,23602,37020,4.5,11.6,18161,3.5,23.2,0,2254,2267,10156
2014,17,217934,277513,5258541,5199812,26184,9.5,23847,8.6,686869,238892,447977,4.6,13.2,569411,199841,369570,3.8,11,117458,2.2,22,0,15515,15577,97042
2014,18,96225,129939,2591650,2561795,10539,8.1,10149,7.8,316830,84711,232119,3.3,12.4,257120,79102,178018,3.1,10,59710,2.4,20,0,6775,6802,45302
2014,19,55054,72526,1303619,1297417,5227,7.2,5033,6.9,129439,41026,88413,3.2,10,117034,38799,78235,3,9,12405,1,18,0,3384,3414,18833
2014,20,51702,66937,1158830,1145792,5799,8.7,5108,7.7,146162,51732,94430,4.5,12.8,120086,38292,81794,3.3,10.5,26076,2.3,21,0,3488,3515,21836
2014,21,61616,83119,1520607,1504761,7709,9.3,6387,7.7,202991,67921,135070,4.5,13.5,171299,52583,118716,3.5,11.4,31692,2.1,22.8,0,4399,4424,29495
2014,22,73387,95992,1682303,1666024,8101,8.5,7330,7.7,222288,70955,151333,4.3,13.3,189730,60388,129342,3.6,11.4,32558,1.9,22.8,0,5126,5155,32650
2014,23,27834,34646,483708,479146,3148,9.1,2809,8.1,58091,21648,36443,4.5,12.1,48966,15464,33502,3.2,10.2,9125,1.9,20.4,0,1737,1748,9469
2014,24,95321,122252,2213085,2188983,11641,9.6,10087,8.3,284005,82997,201008,3.8,13,235800,67731,168069,3.1,10.8,48205,2.2,21.6,0,6667,6692,40461
2014,25,123043,155069,3083257,3061303,13632,8.8,11851,7.7,347509,104682,242827,3.4,11.4,303601,91377,212224,3,9.9,43908,1.5,19.8,0,7681,7735,50685
2014,26,149979,193589,3588109,3542073,16527,8.6,15311,7.9,458894,124707,334187,3.5,13,366822,123226,243596,3.5,10.4,92072,2.6,20.8,0,10170,10220,67858
2014,27,100472,128612,2579874,2534663,11089,8.7,9746,7.6,335407,137675,197732,5.4,13.2,244984,77586,167398,3.1,9.7,90423,3.5,19.4,0,6239,6292,46517
2014,28,40515,54161,899426,892469,4409,8.2,4049,7.5,104288,34849,69439,3.9,11.7,90373,27012,63361,3,10.1,13915,1.6,20.2,0,2964,2969,15873
2014,29,103442,135732,2404154,2375803,14898,11.1,11546,8.6,284128,87991,196137,3.7,12,227426,64207,163219,2.7,9.6,56702,2.4,19.2,0,8266,8289,42401
2014,30,26693,31443,358302,354039,3126,10,2858,9.1,49378,14288,35090,4,13.9,40852,15836,25016,4.5,11.5,8526,2.4,23,0,1839,1849,8148
2014,31,37539,47556,785907,780260,3900,8.3,3258,6.9,84965,24647,60318,3.2,10.9,73670,25009,48661,3.2,9.4,11295,1.5,18.8,0,2142,2155,12032
2014,32,41961,53710,1076416,1053889,7010,13.2,5428,10.3,162709,61649,101060,5.8,15.4,117655,48130,69525,4.6,11.2,45054,4.2,22.4,0,3740,3756,24862
2014,33,26780,33363,550930,545556,2812,8.5,2578,7.8,63195,20980,42215,3.8,11.6,52446,15395,37051,2.8,9.6,10749,2,19.2,0,1756,1778,9674
2014,34,169003,203727,3452318,3444114,20784,10.2,19485,9.6,446660,152348,294312,4.4,13,430251,134298,295953,3.9,12.5,16409,0.5,25,0,13421,13480,79675
2014,35,30875,39515,593968,592873,3538,9,3398,8.6,73272,25931,47341,4.4,12.4,71082,18923,52159,3.2,12,2190,0.4,24,0,2402,2403,11381
2014,36,397937,472460,7819083,7728730,50830,10.8,45122,9.6,1039355,366973,672382,4.7,13.4,858648,286203,572445,3.7,11.1,180707,2.3,22.2,0,30685,30760,174738
2014,37,147314,196646,3395290,3391883,18478,9.4,16754,8.6,431913,134770,297143,4,12.7,425099,168179,256920,5,12.5,6814,0.2,25,0,11456,11518,68045
2014,38,17537,21718,348597,342221,2283,10.7,1720,8,51859,18372,33487,5.4,15.2,39106,13057,26049,3.8,11.4,12753,3.8,22.8,0,1181,1185,6327
2014,39,165740,228034,4653354,4604898,17773,7.8,16525,7.3,569147,170134,399013,3.7,12.4,472235,134185,338050,2.9,10.3,96912,2.1,20.6,0,10864,10965,76334
2014,40,65104,83796,1339559,1324064,7639,9.2,6800,8.2,181887,57371,124516,4.3,13.7,150897,50515,100382,3.8,11.4,30990,2.3,22.8,0,4858,4870,32783
2014,41,78560,97962,1458804,1430595,9932,10.2,8335,8.6,213296,58409,154887,4.1,14.9,156878,48371,108507,3.4,11,56418,3.9,22,0,5714,5735,26370
2014,42,205625,272120,5211465,5162524,22130,8.2,20285,7.5,613176,199392,413784,3.9,11.9,515293,150320,364973,2.9,10,97883,1.9,20,0,13453,13538,82083
2014,44,20855,24752,420819,416132,2126,8.6,2091,8.5,50561,15723,34838,3.8,12.2,41186,13975,27211,3.4,9.9,9375,2.3,19.8,0,1361,1363,9726
2014,45,69399,92292,1595076,1575174,8435,9.2,7492,8.2,198604,64140,134464,4.1,12.6,158799,49646,109153,3.2,10.1,39805,2.5,20.2,0,5231,5263,30897
2014,46,19063,23189,339014,335372,1881,8.1,1782,7.7,39692,12391,27301,3.7,11.8,32407,10503,21904,3.1,9.7,7285,2.1,19.4,0,1237,1245,6960
2014,47,87080,121014,2429351,2404197,10849,9,9572,8,308815,95362,213453,4,12.8,258506,73339,185167,3.1,10.8,50309,2,21.6,0,6773,6789,40140
2014,48,370629,503220,9728017,9588803,54930,11.1,42352,8.5,1468391,520447,947944,5.4,15.3,1189963,397453,792510,4.1,12.4,278428,2.9,24.8,0,29434,29618,206041
2014,49,51483,62972,1117111,1100704,7502,12.1,5932,9.5,163338,56326,107012,5.1,14.8,130523,39251,91272,3.6,11.9,32815,2.9,23.8,0,3944,3949,23959
2014,50,15838,18658,259772,257443,1544,8.3,1474,7.9,28964,8956,20008,3.5,11.3,24305,7447,16858,2.9,9.4,4659,1.9,18.8,0,970,979,5274
2014,51,132515,176856,3117342,3089692,16748,9.5,14495,8.2,411531,143025,268506,4.6,13.3,356232,96995,259237,3.1,11.5,55299,1.8,23,0,9758,9812,48934
2014,53,126327,157519,2448627,2408827,16724,10.7,13997,9,331585,100666,230919,4.2,13.8,251985,83474,168511,3.5,10.5,79600,3.3,21,0,9494,9552,49150
2014,54,25226,34280,568774,567485,2415,7,2751,8,68644,20242,48402,3.6,12.1,66066,21639,44427,3.8,11.6,2578,0.5,23.2,0,1871,1884,10387
2014,55,95287,124208,2426438,2403983,9666,7.8,8894,7.2,267657,78551,189106,3.3,11.1,222747,64698,158049,2.7,9.3,44910,1.8,18.6,0,5960,6005,39250
2014,56,15510,18322,212454,210856,1801,9.9,1597,8.8,30244,9069,21175,4.3,14.3,27047,7840,19207,3.7,12.8,3197,1.5,25.6,0,1072,1074,4098
